SGS-Thomson	JJ
Blue	NNP
Mile	NNP
Mirabel	NNP
immediate	JJ
HOU	NNP
alter	VB
Kong-based	JJ
chickens	NNS
daughters	NNS
insist	VBP
sticks	VBZ
automaker	NN
together	RB
Maynard	NNP
provide	VB
People	NNS
employment	NN
comment	VB
charcoal	JJ
hamburger	NN
Illinois	NNP
Lai	NNP
Jefferson	NNP
Hsing	NNP
urinated	VBN
Dabhol	NNP
Do	VBP
Jerry	NNP
foul	JJ
salted	JJ
Estonia	NNP
Allied	NNP
snowbanks	NNS
school	NN
Alamitos	NNP
shoddy	JJ
implement	VB
Cupiagua	NNP
electrical	JJ
optimism	NN
Marysville	NNP
Orangeburg	NNP
leave	VB
control	NN
and	CC
traveled	VBD
F-Series	NNS
broker	NN
radius	NNS
harbor	NN
Merrick	NNP
offer	NN
Offen	NNP
Winnipeg	NNP
created	VBN
normally	RB
Additional	JJ
six-month	JJ
underground	JJ
doubled	VBD
gets	VBZ
268	CD
nonprofit	JJ
Selleck	NNP
notable	JJ
consumer	NN
fast-developing	JJ
newspaper	NN
inventory	NN
spokeswoman	NN
also	RB
traffic	NN
100,000	CD
expectation	NN
shops	NNS
save	VB
Sandler	NNP
hooked	VBD
profit	NN
JOBS-III-CLR-1	NNP
Prudential	NNP
amateur	NN
customs	NNS
filtration	NN
Italy	NNP
Chips	NNS
When	WRB
risk	NN
visitors	NNS
promoted	VBN
sea	NN
horsepower	NN
GEC	NNP
Middle	NNP
after	IN
garage	NN
No.	NN
Monthly	NNP
sectors	NNS
friends	NNS
Dreyfus	NNP
industry	NN
realized	VBD
enter	VB
rally	NN
courtyard	NN
Court	NNP
Or	CC
...News	.
Irving	NNP
viaduct	NN
lies	VBZ
100-megawatt	JJ
aquatic	JJ
allow	VBP
stay	NN
pioneers	NNS
children	NNS
'll	MD
oldest	JJS
borrower	NN
Turner	NNP
group	NN
encyclopedia	NN
German	JJ
David	NNP
compounds	NNS
scheduled	VBN
C	NNP
starved	VBD
Wilson	NNP
options	NNS
LILC	NNP
stem	NN
State	NNP
keys	NNS
International	NNP
Western	NNP
Ram	NN
Standing	VBG
shells	NNS
Investment	NN
PING	NNP
750	CD
buoyed	VBN
grows	VBZ
Tijuana	NNP
Coke	NNP
front	NN
Dakin	NNP
error	NN
Pearce	NNP
Wonder	NNP
defunct	JJ
Insects	NNS
66	CD
accord	NN
strategic	JJ
Road	NNP
son	NN
daughter	NN
us	PRP
refused	VBD
revenue	NN
parking	NN
chopping	VBG
hanging	VBG
Bohemia	NNP
San	NNP
sweeps	NNS
Cotter	NNP
brewed	VBD
square	NN
quantity	NN
McPheeters	NNP
possibly	RB
its	PRP$
techs	NNS
mounds	NNS
incentive	NN
NYT1	NNP
Yai	NNP
Fever	NNP
Endesa	NNP
engaging	JJ
revitalize	VB
computers	NNS
splintered	VBD
three-year	JJ
Gates	NNP
8,500	CD
clinic	NN
PSA	NNP
destroy	VB
bureau	NN
Serbian	NNP
my	PRP$
tax-exempt	JJ
bitter	JJ
engines	NNS
barbed	JJ
roof	NN
wastewater	NN
Hale	NNP
Woodruff	NNP
generating	VBG
sell	VB
Earnings	NNS
energy	NN
Petroleum	NNP
later	RBR
numerous	JJ
location	NN
eve	NN
Municipal	NNP
Mashpee	NNP
showered	VBN
greeted	VBN
natural	JJ
silicone	NN
generators	NNS
stores	NNS
acquisition	NN
potential	JJ
betting	VBG
700-megawatt	JJ
brightening	VBG
order	NN
1.1	CD
shifts	NNS
2-megawatt	JJ
engine	NN
Unilever	NNP
luscious	JJ
boy	NN
Kenny	NNP
fabricating	VBG
Butcher	NNP
brewery	NN
federal	JJ
construct	VB
`	``
Vitro	NNP
Libya	NNP
Once	RB
Israel	NNP
Republic	NNP
closed	VBN
tiny-leafed	JJ
knowing	VBG
towns	NNS
jetties	NNS
mean	VB
Jersey	NNP
knocked	VBD
cooking	NN
660,000-square-meter	JJ
Christi	NNP
additions	NNS
3M	NNP
representative	NN
profitable	JJ
John	NNP
resilient	JJ
issued	VBN
DAYTON	NNP
reading	NN
lot	NN
interviews	NNS
TO	NNP
projects	NNS
result	NN
`possible	.
lived	VBD
1.35	CD
increasing	VBG
staved	VBD
fixed	VBN
overnight	RB
BBN42	NN
Southfield-based	JJ
staying	NN
similar	JJ
roofs	NNS
tons	NNS
well	RB
evenings	NNS
Bidermann	NNP
stopped	VBD
coca	NN
pools	NNS
laying	VBG
smoke-belching	JJ
addition	NN
Exide	NNP
found	VBD
deeply	RB
You	PRP
year-end	NN
Colbun	NNP
continued	VBN
operations	NNS
studies	NNS
Alsthom	NNP
Hoopis	NNP
habit	NN
DASA	NNP
Boehringer	NNP
begins	VBZ
Kalicz	NNP
Mashusita	NNP
automobiles	NNS
may	MD
step	NN
Hyperion	NNP
rats	NNS
Wolf	NNP
Miami	NNP
Perdue	NN
Juarez	NNP
Business	NN
license	NN
fine	NN
workers	NNS
mile	NN
Poland	NNP
exempted	VBD
exasperated	VBN
train	NN
flay	VBP
comfort	NN
where	WRB
Sr	NNP
measures	NNS
Franklinia	NNP
nature	NN
manages	VBZ
Growing	VBG
occurrences	NNS
woodworking	NN
table	NN
effect	NN
manufacturers	NNS
part	NN
Drug	NNP
Slate	NNP
?	.
meeting	NN
glue	NN
airports	NNS
fiber	NN
capture	VB
picking	VBG
thought	VBN
Flats	NNP
Agawam	NNP
ailments	NNS
Bourges	NNS
make	VB
supercomputer-maker	NN
Streisand	NNP
Greater	NNP
gelatinlike	JJ
bacon	NN
harms	NNS
Ho	NNP
partial	JJ
Seaboard	NNP
worldwide	JJ
Photographing	VBG
536-person	JJ
Hill	NNP
590	CD
Tuesday	NNP
reign	NN
basement	NN
whenever	WRB
we	PRP
pitch	NN
spawned	VBN
stepping	VBG
experts	NNS
Econopac	NNP
Lance	NNP
better	JJR
co-superintendents	NNS
Preserve	NNP
Pierrelatte	NNP
milo	NN
would	MD
tailored	VBN
Seco	NNP
freed	VBN
Home	NNP
letter	NN
convert	VB
Bionaire	NNP
shovel	NN
roasting	VBG
grandfather	RB
Firodia	NNP
Raleigh	NNP
until	IN
angered	VBN
important	JJ
160	CD
pushed	VBD
speaking	VBG
Wal-Mart	NNP
west	JJS
confidence	NN
Petersburg	NNP
Raised	VBN
ABS	NNP
Augusta	NNP
this	DT
nylon	NN
principal	JJ
Kelly	NNP
nuclear	JJ
microprocessor	NN
returning	VBG
weapons-manufacturing	JJ
suspension	NN
wife	NN
ready	JJ
Phelps	NNP
Firestone	NNP
assets	NNS
delivers	VBZ
About	IN
Northwest	NNP
releasing	VBG
embarked	VBN
Nuys	NNP
psychiatric	JJ
Dallas	NNP
sent	VBD
oil	NN
told	VBD
equal	JJ
Shreveport	NNP
Peru	NNP
Chrysler	NNP
Sanders	NNP
:41	CD
clears	VBZ
routine	JJ
gasoline	NN
approve	VB
here	RB
Taurus	NNP
nicotine	JJ
converted	VBN
18	CD
Serbia	NNP
air	NN
eagerly	RB
worst	JJS
survey	NN
Metro	NNP
fired	VBN
hands	NNS
delayed	VBD
Legnica	NNP
singing	VBG
consumption	NN
Investments	NNPS
Apparel	JJ
crushing	NN
melting	JJ
Defense	NNP
swam	NN
Orinoco	NNP
taxes	NNS
Austin	NNP
Yuma	NNP
stultify	VB
door	NN
clumps	NNS
If	IN
Microchip	NNP
Avenger	NNP
churning	VBG
ecologist	NN
prosecutors	NNS
live	VBP
Ron	NNP
producing	VBG
Colorado-based	JJ
solid	JJ
lenient	JJ
Textile	NNP
bus	NN
either	DT
aggressive	JJ
Vermont	NNP
construction	NN
Massachusetts	NNP
retirements	NNS
Indeed	RB
elaborate	VB
eliminating	VBG
de	IN
lifetimes	NNS
touting	VBG
paying	VBG
Shop	NNP
council	NN
kept	VBN
Knott	NNP
alpine	JJ
Nix	NNP
speed	NN
Metallgesellschaft	NNP
yet-to-be-built	JJ
tourists	NNS
Hinkley	NNP
1/03	NNP
Briefly	NNP
Hardie	NNP
83.0	CD
category	NN
Spain	NNP
circuit	NN
Dillon	NNP
fanatic	NN
Indiana	NNP
video	NN
gardening	NN
Bethlehem	NNP
advises	VBZ
1412EST	CD
1.5	CD
briquets	NNS
advertises	VBZ
supermarkets	NNS
barge	NN
draw	VB
Station	NNP
legislation	NN
warned	VBN
improving	VBG
included	VBD
mold	NN
Owner	NNP
scorch	NN
1917	CD
Considering	VBG
friend	NN
OIL	NNP
850	CD
J.	NNP
bill	NN
Worldwide	NNP
250,000-ton	JJ
Smart	NNP
Smet	NNP
helium	NN
gallons	NNS
licenses	NNS
people	NNS
wood-free	JJ
availability	NN
SELLECK-DEVELOPERS-LADN-CLR	NNP
Government	NN
superconducting	VBG
impoverished	JJ
computer-chip	JJ
spurred	VBN
Bob	NNP
Sales	NNS
eyewear	NN
environmentalists	NNS
successful	JJ
takes	VBZ
teaching	VBG
levels	NNS
course	NN
ice-cream	JJ
oriented-strand-board	NN
Sergio	NNP
startup	JJ
sky	NN
17	CD
virtual	JJ
implementation	NN
contribute	VB
yuan	NN
commissioning	NN
industry-wide	JJ
agaves	NNS
BEACH	NNP
Britain	NNP
rocky	JJ
By	IN
Doug	NNP
Martin	NNP
750,000	CD
SENATE	NNP
slowdown	NN
reviews	NNS
Banking	NNP
Medical	NNP
wasteland	NN
shape	VB
founded	VBN
southeastern	JJ
gotten	VBN
sworn	VBN
Micron	NNP
revive	VB
Vehicle	NNP
rises	VBZ
weakness	NN
run	VB
grown	VBN
beneficiary	JJ
reserves	NNS
schmoozing	VBG
science	NN
signed	VBD
needed	VBD
celery-packing	JJ
cognizant	NN
protect	VBP
BMW's	DT
lands	NNS
ballet	VB
beginning	VBG
direction	NN
luggage	NN
microscopic	NN
bonds	NNS
Burma	NNP
competitor	NN
Fletcher	NNP
international	JJ
seven-year	JJ
power	NN
threatened	VBN
label	NN
Venezuelan	JJ
after-tax	JJ
DEC	NNP
poured	VBD
Phase	NNP
landfill	NN
nut	NN
President	NNP
tourism	NN
Kan.	NNP
seven-page	JJ
fate	NN
sizable	JJ
urn	NN
How	WRB
lens-finishing	NN
Indianapolis	NNP
Northborough	NNP
Integrated	NNP
Maracaibo	NNP
strain	NN
insurance	NN
margin	NN
suffer	VB
38	CD
been	VBN
Microelectronics	NNP
washed	VBD
Reserve	NNP
reproduce	VB
Both	DT
situated	VBN
grocery	NN
taping	VBG
WLR	NNP
successively	RB
82	CD
2,000	CD
Schaumburg	NNP
substitute	NN
training	NN
Cos	NNP
Pontiac	NNP
II	NNP
controls	NNS
alerted	VBD
Pioneer	NNP
dictates	NNS
subsidiaries	NNS
Douglas	NNP
you	PRP
Five	CD
achieved	VBN
68	CD
Puyallup	NN
Channel	NNP
shutting	VBG
mostly	RB
pays	VBZ
forcing	VBG
7/8	CD
Rinso	NNP
designed	VBN
car-making	NN
Turbo	NN
contributor	NN
sewage	NN
enterprise	NN
Wash	NNP
arms	NNS
extracted	VBN
houses	NNS
submarine	JJ
Fuji	NNP
dry	JJ
extensive	JJ
StorageTek	NNP
camouflaged	JJ
Spencer	NNP
Disney	NNP
debris	NN
advanced	JJ
tending	VBG
bags	NNS
Another	DT
assist	VBP
soybean	NN
intelligence	NN
trades	NNS
three-and-half	JJ
projected	VBN
Tallinn	NNP
Foods	NNP
Aires	NNPS
entice	VB
develops	VBZ
Bladensburg	NNP
store	NN
but	CC
can	MD
Tom	NNP
first-quarter	JJ
beating	VBG
findings	NNS
followers	NNS
cooling	VBG
bargaining	NN
Research	NNP
probably	RB
bulk	NN
domestic	JJ
Trudi	NNP
instituting	VBG
Barbera	NNP
adjacent	JJ
full-service	JJ
article	NN
afternoon	NN
throaty	NN
Free	NNP
hide	VB
impetus	NN
Dr.	NNP
directly	RB
Lamar	NNP
personal	JJ
NRG	NNP
myself	PRP
Davao	NNP
1964	CD
bid	NN
meatpacking	JJ
abroad	RB
Iscor	NNP
PHASING	VBG
or	CC
constructed	VBN
population	NN
Production	NN
1/2	CD
reacted	VBD
Norway	NNP
Linda	NNP
seamless	JJ
Svoboda	NNP
Trade	NNP
officers	NNS
Conn.	NNP
bubble	JJ
Rutledge	NNP
Georgia	NNP
sing	VB
fallen	JJ
updated	VBN
TRW	NNP
Equitable	NNP
bush	JJ
Marseilles	NNP
Consequently	RB
-01-15-96	CD
symbolic	JJ
complaints	NNS
airport	NN
He	PRP
15	CD
Nacional	NNP
nerve	NN
diversity	NN
diskettes	NNS
sites	NNS
promised	VBN
Singh	NNP
ice	NN
re-election	NN
open-skies	JJ
Souths	NNS
''Gyll	NNP
starting	VBG
2	CD
B.A.S.S	NNP
dioxide	NN
Fleischmann	NNP
Mazda	NNP
island	NN
sending	VBG
EOS	NNS
permit	NN
tunnel	NN
replaced	VBD
elsewhere	RB
overcome	VB
Moammar	NNP
today	NN
disco	NN
F-150	NN
pointing	VBG
Mark	NNP
S.	NNP
1987	CD
stockpile	NN
clueless	JJ
northeast	RB
Gingrich	NNP
revolutionary	JJ
Readville	NNP
guerrillas	NNS
far-reaching	JJ
conferences	NNS
fraction	NN
audience	NN
scenario	NN
implications	NNS
April	NNP
Still	RB
Marvel	NNP
presidential	JJ
'm	VBP
assessment	NN
Lights	NNP
low	JJ
Lee	NNP
Bid	NNP
father	NN
injection	NN
bakeries	NNS
homes	NNS
polyethylene	NN
courts	NNS
argued	VBD
briquet	NN
Latin	NNP
indicate	VB
Palace	NNP
Korea	NNP
envision	VB
lens	NN
seven	CD
discovery	NN
safety	NN
Evansville	NNP
mountaintop	NN
watered	VBN
cancer-fighting	JJ
whatsoever	RB
talked	VBD
dog	NN
meaning	VBG
Prentiss	NNP
Echols	NNP
Kimberly-Clark	NNP
outdoors	NNS
seeking	VBG
matters	NNS
link	NN
appliance	NN
Frans	NNS
closer	JJR
Mobil	NNP
becoming	VBG
Yokkaichi	NNP
stuff	NN
two-week	JJ
applies	VBZ
savings	NNS
milder	JJ
Michael	NNP
Charles	NNP
2-24	CD
Television	NNP
intention	NN
senior	JJ
read	NN
game	NN
traditional	JJ
235	CD
expanding	VBG
30,000	CD
Engibous	NNP
Works	NNP
AG	NNP
capsules	NNS
Hewlett-Packard	NNP
Shell	NNP
Luis	NNP
High	NNP
notice	NN
TV	NN
third-largest	JJ
Fresh	NNP
delegations	NNS
240,000	CD
Reuther	NNP
Nigeria	NNP
sulfuric	JJ
Klinkert	NNP
conference	NN
expectations	NNS
grain	NN
Satterfield	NNP
22	CD
Freeway	NNP
cool	JJ
trampled	VBN
harvest	NN
19.8	CD
Calcutta	NNP
added	VBD
Yet	RB
flames	NNS
Facility	NN
marine	JJ
acquire	VB
high-tech	JJ
Taggart	NNP
plantation	NN
unabated	JJ
treated	VBN
drugs	NNS
invited	VBN
drained	VBD
malt	NN
providing	VBG
following	VBG
wet	JJ
usually	RB
isolation	NN
logo	NN
variety	NN
appeared	VBD
malfunctioning	JJ
Kodak	NNP
big-ticket	JJ
leads	VBZ
LX	NNP
purchaser	NN
fashion	NN
Philip	NNP
controversy	NN
Bowl	NNP
Complicating	VBG
eliminates	VBZ
permission	NN
sewed	VBD
grader	NN
Rockville	NNP
societies	NNS
conceded	VBD
am	VBP
bringing	VBG
largely	RB
ever	RB
time	NN
24	CD
major	JJ
conglomerate	NN
telling	VBG
Energy	NNP
car-maker	NN
expects	VBZ
our	PRP$
Twin	NNP
Polish	JJ
centerpiece	NN
inches	NNS
According	VBG
Wellman	NNP
estrogens	NNS
SMA	NNP
Catania	NNP
erred	VBD
maintenance	NN
Stoker	NNP
street	NN
slump	NN
Ludwigshafen	NNP
feuding	VBG
32	CD
Gothenburg	NNP
heavily	RB
510	CD
setting	VBG
Hills-based	JJ
against	IN
CLEARWATER	NNP
loss	NN
Weybridge	NNP
Philippines	NNPS
leaving	VBG
claim	VBP
Guy	NNP
protectionism	NN
spokesmen	NNS
room	NN
8.8	CD
will	MD
requires	VBZ
secondary	JJ
Pentagon	NNP
Economic	NNP
offshore	JJ
according	VBG
2,700	CD
flight	NN
Best	NNP
herb	NN
analyses	NNS
nuts	NNS
Guacolda	NNP
Ill.	NNP
spend	VB
regulations	NNS
839-2111	CD
Sour	NNP
compensate	VB
clandestine	JJ
jars	NNS
York-based	JJ
fix	VB
credit	NN
Hampshire	NNP
Pantex	NNP
Yoav	NNP
tract	NN
County	NNP
describing	VBG
Appert	NNP
recalls	VBZ
both	DT
components	NNS
world-competitive	JJ
18,000	CD
reached	VBN
Norden	NNP
assortment	NN
Jacksonville	NNP
Volkswagen	NNP
committee	NN
cream	NN
European	JJ
vitamins	NNS
pipelines	NNS
one	CD
cocoon	NN
efficient	JJ
relates	NNS
unfair	JJ
remote	JJ
help	VB
Centrais	NNP
Montreal	NNP
35,620	CD
rely	VB
conforms	VBZ
Engineering	NNP
Mercedes-Benz	NNP
Wages	NNS
soon	RB
Verde	NNP
gold	NN
grafts	NNS
Anne	NNP
above	IN
officials	NNS
reason	NN
licensed	VBN
recombined	VBN
compliance	NN
much	JJ
Arrow	NNP
uses	VBZ
oversight	NN
restored	VBN
Covington	NNP
stuck	VBD
Trends	NNPS
500-megawatt	JJ
attached	VBN
Instruments	NNP
Pink	NNP
generator	NN
driving	VBG
27	CD
1989	CD
KCRW-FM	NNP
Caterpillar	NNP
Smoky	NNP
Europe	NNP
editor	NN
expressed	VBN
Hillsboro	NNP
pure-oxygen	NN
Victoria	NNP
rebuild	VB
570	CD
plate	NN
clothing	NN
War	NNP
caretakers	NNS
text	NN
Competition	NNP
evaluation	NN
references	NNS
Slovenia	NNP
putting	VBG
rupees	NNS
moving	VBG
scientists	NNS
Spire	NNP
guys	NNS
lit	JJ
any	DT
House	NNP
June	NNP
amount	NN
supposed	VBN
counting	VBG
marinating	VBG
planned	VBD
really	RB
Pop	NNP
indication	NN
hazardous	JJ
Mrs	NNP
gridlock	NN
inexperience	NN
Greenwood	NNP
Abhaykumar	NNP
Cutlass	NNP
gathering	VBG
Pfister	NNP
Canadians	NNPS
Williams	NNP
Honeywell-Bull	NNP
destined	VBN
waited	VBD
Doubleday	NNP
Signal	NNP
Grumbly	NNP
Charlotte-based	JJ
pharmaceutical	JJ
protozoans	NNS
curing	VBG
slate	NN
tax	NN
Permitted	NNP
Don	NNP
17:36	CD
owned	VBN
painted	VBN
mln	CD
crowd	NN
government	NN
containment	NN
Galitzki	NNP
tobacco	NN
whom	WP
concerning	VBG
hurt	VB
now	RB
Fire	NNP
history	NN
suggests	VBZ
M.	NNP
Northern	NNP
observation	NN
arsenic	NN
last	JJ
dinosaur	NN
sweatshirt	NN
phased	VBN
subway	NN
Food	NNP
Antonio	NNP
misshapen	JJ
getting	VBG
agog	NN
letters	NNS
beer	NN
Altamira	NNP
Brownie	NNP
Argentine	JJ
70	CD
E	NNP
barbecue	NN
Ore	NNP
protesters	NNS
213	CD
book	NN
farcical	JJ
50,000-square-foot	JJ
Loomis	NNP
Sen	NNP
farewell	NNP
mother	NN
90	CD
sulfur	NN
topics	NNS
Boot	NNP
tritium	NN
ice-making	JJ
broke	VBD
doomed	VBN
Argos	NNPS
subterranean	JJ
central	JJ
military	JJ
percent-owned	JJ
Daimler-Benz	NNP
users	NNS
Week	NNP
Loop	NN
lacy	NN
Mitsuhiro	NNP
fight	VBP
19,000	CD
challenge	NN
Timken	NNP
While	IN
most	JJS
struggling	VBG
includes	VBZ
esthetic	JJ
frozen-food	NN
seems	VBZ
uncertainties	NNS
Cement	NNP
pretext	NN
corner	NN
foams	NNS
regressive	JJ
bass	NN
Commerce	NNP
fund-raiser	NN
incorrigible	JJ
Softdrinks	NNPS
mill	NN
Large	JJ
Telectronics	NNP
extreme	JJ
reminded	VBN
1956	CD
cards	NNS
Thyssen	NNP
just	RB
Susan	NNP
:29	CD
Banpu	NNP
determined	VBD
Hydro	NNP
rising	VBG
Chechnya	NNP
Stream	NNP
sustenance	NN
negotiating	VBG
yellow	JJ
state-owned	JJ
lectures	VBZ
finishing	VBG
Mannion	NNP
Eliminate	NNP
Vance	NNP
Work	NN
snapshot	NN
human	JJ
championing	VBG
Duracraft	NN
radioactive	JJ
Brooklyn	NNP
1.2-billion	JJ
Stanley	NNP
Schneider	NNP
convict	VB
sometime	RB
injured	VBN
SUBSIDIES	NNP
appear	VB
Soul	NNP
Methuen	NNP
importance	NN
higher	JJR
achievements	NNS
haven	NN
should	MD
minority	NN
interruption	NN
bakery	NN
fruit	NN
tailings	NNS
Pickering	NNP
staffer	NN
made	VBN
per	IN
metric	JJ
handed	VBN
assessors	NNS
refrigeration	NN
McCarty	NNP
polluting	VBG
Seeds	NNP
indirect	JJ
Joshi	NNP
filtering	NN
Carbide	NNP
shift	NN
Act	NNP
Quebec	NNP
Pennsylvania	NNP
pest	JJ
burned	VBN
fighter	NN
mansion	NN
reservoir	NN
state-of-the-art	JJ
strategy	NN
drawing	NN
unsuccessful	JJ
500	CD
guarantee	VBP
mothballed	JJ
Bartram	NNP
agreement	NN
wells	NNS
Kansas	NNP
Dragados	NNP
NEW	NNP
1-5	CD
Development	NNP
Chairman	NNP
Fort	NNP
drainage	NN
house	NN
underconsumption	NN
WirtschaftsWoche	NNP
Lansing	NNP
deadlocked	VBN
blew	VBD
Ice	NNP
panels	NNS
-	:
owns	VBZ
Paul	NNP
Palm	NNP
warrant	VB
detailing	VBG
on	IN
proud	JJ
Caruolo	NNP
pulled	VBD
Brothers	NNP
tied	VBN
Before	IN
no	DT
Bakeries	NNP
exported	VBN
marriage	NN
return	VB
1924	CD
4.4	CD
Nova	NNP
Joy	NN
Raba	NNP
10	CD
generations	NNS
slip	VB
Daily	NNP
3.7	CD
Deer	NNP
Waterford	NNP
fiber-optics	JJ
gain	VB
draws	VBZ
2-14	CD
call	VB
steam	NN
exterior	NN
hardside	NN
Occupational	NNP
office	NN
Olympic	NNP
authorization	NN
software	NN
sets	VBZ
Madhya	NNP
temporary	JJ
EMU	NNP
collapse	NN
museum	NN
refiner	NN
gunmen	NNS
applause	NN
arsenal	NN
anyone	NN
liquefied	VBN
improve	VBP
predilection	NN
influences	VBZ
keep	VB
maintain	VB
minimum	NN
impact	NN
Nampo	NNP
petiole	JJ
going	VBG
Baird	NNP
Milliken	NNP
Mario	NNP
-LCB-	-LRB-
bolivar-denominated	JJ
Mayor	NNP
enable	VB
Electricidad	NNP
surprised	JJ
program	NN
knees	NNS
efficiency	NN
barons	NNS
cutbacks	NNS
Rhone	NNP
Fidel	NNP
veteran	NN
Laos	NNP
Ask	NNP
Whitby	NNP
learning	VBG
Sulejman	NNP
states	NNS
Chefs	NNS
1993	CD
burst	NN
Semiconductor	NNP
Lakeside	NNP
recommended	VBN
decades	NNS
estimate	VB
drink	NN
Massaschusetts	NNP
tolerate	VB
reorganisation	NN
undergoing	VBG
minute	NN
guilty	JJ
Bush	NNP
conservation	NN
shade	NN
Nissan-Cohen	NNP
Cheshire	NNP
mist	NN
Piana	NNP
Humor-Breyers	NNP
tracks	VBZ
Alexander	NNP
atomic	JJ
Ceval	NNP
ABF	NNP
sole	JJ
administration	NN
regime	NN
official	NN
uncertainty	NN
dissolver	NN
Rover	NNP
accepted	VBN
cellophane-like	JJ
reaction	NN
city	NN
Judging	VBG
obscure	JJ
yard	NN
Hitt	NNP
delivered	VBN
nonfiction	NN
ideas	NNS
cutoff	NN
tables	NNS
landscape	NN
GasAndes	NNP
Ireland	NNP
man	NN
121-worker	JJ
incident	NN
CR-V	NNP
opening	VBG
Brian	NNP
'd	MD
Westinghouse	NNP
1994/95	CD
Greensboro	NNP
distilled	JJ
before	IN
nomination	NN
failure	NN
SoundView	NNP
decreasing	VBG
Insurers	NNP
Thunderbirds	NNS
Nucor	NNP
Boylston	NNP
Even	RB
admit	VBP
pointed	VBD
rules	NNS
rights	NNS
28	CD
Sciences	NNPS
Honeywell	NNP
write	VB
Star-Telegram	NNP
outlying	JJ
export-driven	JJ
Cogentrix	NNP
bananas	NNS
points	NNS
butcher	NN
losses	NNS
blaze	NN
suit	NN
survive	VB
produces	VBZ
enough	RB
Advanced	NNP
bonuses	NNS
price	NN
Chemical	NNP
track	VB
shuttered	VBN
tremors	NNS
Lentjes	NNP
pier	NN
hoping	VBG
turn	VB
vans	NNS
N.Y.	NNP
southwest	JJS
home-produced	JJ
models	NNS
20,000	CD
publicly	RB
consumed	VBN
shipped	VBN
Angelo	NNP
bearings	NNS
good	JJ
changed	VBN
under	IN
producers	NNS
looking	VBG
agree	VB
hopes	VBZ
Foreign	JJ
medium-to-large	NN
Industry	NNP
only	RB
midst	NN
splitting	NN
fish	NN
billion-a-year	JJ
mixture	NN
Arnold	NNP
Firebirds	NNS
park	NN
Arnotts	NNP
Nonsense	NN
Pernis	NNP
wild	JJ
superintendent	NN
West	NNP
decides	VBZ
University	NNP
Mo	NNP
Mississippi	NNP
Eric	NNP
milk-storage	JJ
bidding	NN
antibiotics	NNS
accounts	NNS
wafers	NNS
M&M	NNP
garlic	NN
requiring	VBG
Bishop	NNP
dated	VBN
shortage	NN
generated	VBN
varieties	NNS
fears	VBZ
pounding	VBG
Rioclaro	NNP
rate	NN
privatization	NN
dedication	NN
increase	VB
sick	JJ
Chullora	NNP
Components	NNP
Baker	NNP
Herradura	NNP
King	NNP
revolution	NN
range	NN
case	NN
formidable	JJ
day	NN
thus	RB
BP	NNP
Dresden	NNP
heating	NN
refineries	NNS
western	JJ
burgeoning	VBG
suppliers	NNS
assigned	VBN
Solheim	NNP
accidents	NNS
geothermal	JJ
Paso	NNP
withheld	VBN
91.531	CD
quarter	NN
Navy	NNP
steelmaker	NN
vacant	JJ
stories	NNS
Turkish	JJ
began	VBD
phone	NN
stemming	VBG
rigged	VBD
watching	VBG
creation	NN
minitruck	NN
relations	NNS
sun	NN
Piedmont	NNP
a	DT
without	IN
peninsula	NN
belt	NN
maybe	RB
2337EST	CD
185	CD
Along	IN
announcing	VBG
Norwalk	NNP
e8~	JJ
bag	NN
Cayuga	NNP
invested	VBD
movement	NN
displaced	VBD
Italian	JJ
pesetas	NNS
cleanup	NN
Alberto	NNP
1,800	CD
Spice	NNP
reflect	VB
festive	JJ
155	CD
begun	VBN
reasoned	VBD
1,300	CD
wood	NN
trench	NN
Strooij	NNP
Village	NNP
Marketing	NNP
flagging	VBG
cut	VB
forming	VBG
mid-Atlantic	JJ
Brahma	NNP
Cristaleria	NNP
screens	NNS
stronger	JJR
least	JJS
But	CC
function	NN
anniversary	NN
ore	NN
proposes	VBZ
laces	VBZ
Talk	NNP
grant	NN
investment	NN
350	CD
jets	NNS
Corp.	NNP
Following	VBG
athletic	JJ
motivated	VBN
Ted	NNP
initiated	VBD
storied	JJ
nutrition	NN
ad	NN
closure	NN
insured	VBD
orimulsion	NN
1983	CD
DAY	NNP
elected	VBN
National	NNP
thereby	RB
THE	DT
1998	CD
them	PRP
understanding	NN
upper	JJ
veiled	VBN
two-year-old	JJ
preparing	VBG
190,000	CD
Evidence	NN
renounce	VB
Properly	RB
inmates	NNS
volumes	NNS
build	VB
EXE	NNP
shouts	NNS
reproducing	VBG
flourishes	VBZ
Collider	NNP
instance	NN
McDonnell	NNP
sports	NNS
rear	JJ
form	NN
Spring	NNP
ONLY	NNP
CNG	NNP
Biological	NNP
Avonex	NNP
yearly	JJ
big	JJ
Serb	NNP
real	JJ
Wheelbase	NNP
They	PRP
CDI	NNP
with	IN
barrels	NNS
withdraw	VB
sunk	VBN
experience	NN
damages	NNS
five-day	JJ
me	PRP
sewers	NNS
compete	VB
jab	NN
whiff	NN
idled	VBN
scrub	NN
mass	NN
Millions	NNS
critics	NNS
pressure	NN
floors	NNS
developed	VBN
rum	NN
attorney	NN
2.2	CD
toys	NNS
employees	NNS
Ga	NNP
sank	VBD
anonymous	JJ
over	IN
8,400	CD
carmaker	NN
gift	NN
North	NNP
forests	NNS
catalogues	NNS
supply	NN
Paulo	NNP
Potentially	RB
pounds-a-year	JJ
baby	NN
misleading	VBG
Coors	NNP
emerged	VBD
:12	CD
camp	NN
Framingham	NNP
scale	NN
whistleblowers	NNS
~	``
Gold	NNP
enticing	VBG
plans	VBZ
exposed	VBN
reductions	NNS
gray-haired	JJ
Wiscasset	NNP
Protestant	JJ
quipped	VBD
1804	CD
steward	RB
Cities	NNPS
57,948	CD
Congress	NNP
snowed	VBD
insiders	NNS
complete	VB
Virtual	NNP
Trent	NNP
assailed	VBN
Since	IN
stamping	NN
prestigious	JJ
insider	NN
internal	JJ
researchers	NNS
APPROVES	NNP
Wachs	NNP
parks	NNS
Minister	NNP
carefully	RB
certain	JJ
Located	VBN
underwent	VBD
ethanol	NN
pounds	NNS
Putnam	NNP
end	NN
never	RB
Rourkela	NNP
Sept.	NNP
economy	NN
-LRB-	-LRB-
sees	VBZ
space	NN
name-calling	NN
Charn	NNP
lion	NN
wireless	JJ
closures	NNS
Jain	NN
places	NNS
1.99	CD
cigarette	NN
plant	NN
newsprint	NN
Whittier	NNP
Mining	NNP
Manufacturer	NNP
revolving	JJ
rides	VBZ
N.J.	NNP
something	NN
fortunes	NNS
mailroom	NN
Beasley	NNP
Denver	NNP
level	NN
storage	NN
signals	NNS
computer	NN
cans	NNS
Merlo	NNP
because	IN
gained	VBN
window	NN
season	NN
Now	RB
paper-packed	JJ
Linnell	NNP
economic-development	JJ
Sitix	NNP
leader	NN
grants	NNS
letting	VBG
pace	NN
frame-making	JJ
Abbot	NNP
television	NN
Feigenbaum	NNP
newsroom	NN
cleaner	JJR
clown	VBN
soaring	VBG
qualify	VB
branched	VBD
high-technology	NN
horns	NNS
Pasquale	NNP
Hi	NNP
Zerbib	NNP
heat	NN
commercial	JJ
experiments	NNS
soft-pedal	VB
retool	VB
enthusiasts	NNS
cash	NN
29	CD
Arlington	NNP
Quarterly	JJ
Rancho	NNP
stable	JJ
billow	VB
Fontana	NNP
Celic	NNP
nearly	RB
Mitchell	NNP
Gas	NNP
steps	NNS
Neeley	NNP
low-calorie	JJ
Petrocorp	NNP
steer	VB
Soviet	NNP
horticultural	JJ
effectively	RB
accused	VBD
Stew	NNP
Let	VB
degenerating	VBG
sweeping	VBG
wheels	NNS
covering	VBG
Rival	NNP
lines	NNS
concept	NN
politics	NNS
driver	NN
deep	JJ
Albans	NNP
inspected	VBD
Carra	NNP
botanical	JJ
dogged	VBN
assignment	NN
surveillance	NN
expert	NN
Montupet	NNP
Darlington	NNP
tested	VBN
grinding	NN
Onoda	NNP
Venezuelan-American	JJ
snack	NN
19-year-old	JJ
around	IN
fishermen	NNS
papers	NNS
Backhaus	NNP
fires	NNS
then	RB
candidacy	NN
Fells	NNS
applied	VBN
Glance	NN
finery	NN
tag	NN
plan	NN
creek	NN
O	NNP
Chicago	NNP
Field	NNP
World	NNP
Kingston	NNP
parts	NNS
pages	NNS
dominated	VBD
cough	VB
lush	JJ
Justin	NNP
disorders	NNS
British	NNP
Danny	NNP
needs	VBZ
Pratt	NNP
leeway	NN
80	CD
minister	NN
paralegal	NN
donated	VBN
Matsumoto	NNP
concentrations	NNS
airplanes	NNS
unusual	JJ
discuss	VB
Newcastle	JJ
trade	NN
Container	NNP
Audi	NNP
13.2	CD
Buenos	NNPS
wartime	NN
confrontational	JJ
press	NN
repairs	NNS
Hawthorne	NNP
won	VBD
emphasized	VBD
adopted	VBN
preserving	VBG
vitriolic	JJ
are	VBP
In	IN
investor	NN
Oradell	NNP
Factory	NN
cost-cutting	JJ
ground	NN
Econoline	NNP
focused	VBN
EV1	NN
DuPont	NNP
glass	NN
next	JJ
1976	CD
tampered	VBN
escaped	VBN
guidelines	NNS
sliced	VBN
Physics	NNP
-01-16-96	CD
halted	VBD
become	VBN
trucks	NNS
installed	VBN
500-million	CD
whole	JJ
many	JJ
Tewksbury	NNP
aircraft	NN
cost	NN
cheered	VBD
Sydney	NNP
outlets	NNS
pharmaceuticals	NNS
year-old	JJ
memorandum	NN
hogs	NNS
Saratoga	NNP
12	CD
professionals	NNS
specialty	NN
Asian	JJ
Denton	NNP
putrid	VBD
tired	VBN
amendments	NNS
Migdal	NNP
taken	VBN
Consolidated	NNP
FLETCHER	NNP
milliliter	NN
kisses	VBZ
taking	VBG
Alsons	NNS
Enclose	VB
zigzagging	VBG
left	VBN
Vitos	NNS
local	JJ
1,000-megawatt	JJ
spending	VBG
Crowley	NNP
passes	NNS
McDermott	NNP
My	PRP$
farm	NN
Fructal	NNP
modernization	NN
buys	VBZ
Alps	NNP
elements	NNS
Windsor	NNP
secret	NN
used	VBN
Tire	NN
Corimon	NNP
protecting	VBG
$	$
cleaned	VBN
behavior	NN
continuous-running	JJ
Chi	NNP
Funny	JJ
supporters	NNS
separation	NN
Albuquerque	NNP
Buy	VB
visited	VBN
R-Fla	NNP
talk	VBP
non-leaf	JJ
vehicle	NN
name	NN
pollen	NN
super-chilled	JJ
funded	VBN
rankled	VBD
Riordan	NNP
capped	VBD
1.5-million	CD
homeland	NN
kind	NN
Asia	NNP
establishment	NN
District	NNP
cleans	VBZ
September	NNP
breakdowns	NNS
autos	NNS
officer	NN
Supreme	NNP
Philmotors	NNP
crowded	VBN
Main	NNP
men	NNS
Washington	NNP
meltdown	NN
F.	NNP
confirm	VB
solution	NN
plentiful	JJ
stirring	VBG
disarmament	NN
VVER-440	JJ
though	IN
marathon	NN
flax	NN
reflected	VBD
NEWS	NNP
roundtable	JJ
shopping	NN
Burmine	NNP
Exell	NNP
state	NN
strictly	RB
latches	NNS
LaGrange	NNP
unintentionally	RB
forestry	NN
HILLS	NNP
Coffee	NNP
systemwide	JJ
BBN	NNP
halting	VBG
cymbal	NN
under-used	JJ
Fund	NNP
fronts	NNS
aware	JJ
eager	JJ
departure	NN
blast-furnace	JJ
announcement	NN
slowed	VBD
Karoff	NNP
710	CD
deals	NNS
Tekely	NNP
schooled	VBN
hire	NN
grown-ups	NNS
suite	NN
rail	NN
Americans	NNPS
estate	NN
Regulatory	NNP
look	NN
B.	NNP
Russia	NNP
Sundlink	NNP
ton	NN
feeding	VBG
awarded	VBD
Thursday	NNP
passive-aggressive	JJ
fog-bound	JJ
hall	NN
Connection	NNP
roll	VBP
below	IN
Ang	NN
cookbooks	NNS
refueling	NN
especially	RB
applications	NNS
integrated	JJ
automotive	JJ
suspicious	JJ
Northeast	NNP
Cross	NNP
contending	VBG
Justice	NNP
space-related	JJ
duty-free	JJ
England	NNP
physicists	NNS
infested	VBN
religious	JJ
sign	NN
Rotterdam	NNP
somebody	NN
2000	CD
works	NNS
retreated	VBD
Judge	NNP
%	NN
asset	NN
believed	VBD
spends	VBZ
1920s	CD
Phinma	NNP
executives	NNS
eye	NN
his	PRP$
However	RB
put	VB
Army	NNP
Edison	NNP
Economista	NNP
WordPerfect	NNP
revamping	NN
newest	JJS
demise	NN
latitude	NN
warriors	NNS
antioxidant	JJ
lifetime	NN
islands	NNS
Everywhere	RB
designation	NN
mister	NN
Drive	NNP
Spokesman	NNP
furtive	JJ
grandfathers	NNS
mistakes	NNS
litter	NN
along	IN
address	VB
lifting	NN
Miller	NNP
phase	NN
Maria	NNP
counts	NNS
Georgetown	NNP
Balkan	NNP
Eaton	NNP
hurting	VBG
Plenty	NN
slashing	VBG
Geese	NNP
thigh	NN
prospects	NNS
customer	NN
286	CD
For	IN
discharge	NN
stations	NNS
version	NN
Caldwell	NNP
hated	VBD
eligible	JJ
win	VB
substantial	JJ
horror	NN
closings	NNS
terminating	VBG
halt	NN
Taipei	NNP
problems	NNS
cast	VB
coffee	NN
paper	NN
specifications	NNS
pungency	NN
Anheuser-Busch	NNP
Biber	NNP
Marcos	NNP
shoppers	NNS
cactus	NN
concentrating	VBG
spring	NN
modest	JJ
Just	RB
communist	JJ
Texas	NNP
Meditation	NNP
services	NNS
Bechtel	NNP
rush	VB
respond	VB
non-power	JJ
zone	NN
neighboring	VBG
Contractor	NNP
Socrates	VBZ
nationality	NN
granted	VBN
November	NNP
Pa.	NNP
market-sensitive	JJ
107,000	CD
says	VBZ
ISI	NNP
less	JJR
brought	VBN
another	DT
enthusiasm	NN
severance	NN
multi-branching	JJ
turbocharger	NN
Lew	NNP
worked	VBD
topped	VBD
Opel	NNP
design	NN
startled	VBN
metal	NN
oral	JJ
ripe	NN
McNulty	NNP
Metz	NNP
rejects	NNS
First	NNP
promises	NNS
region	NN
Citadel	NNP
bragging	JJ
11th	JJ
Monju	NNP
widely	RB
microwave	NN
deduct	VB
futures	NNS
once	RB
salary	NN
mosquitoes	NNS
convergence	NN
selected	VBD
logos	NNS
expansion	NN
stiff	JJ
writedown	NN
schools	NNS
sealing	VBG
proclaims	VBZ
limited	VBN
direct-investment	NN
feel	VB
reorganization	NN
defraud	VB
Mills	NNP
transported	VBN
political	JJ
1965	CD
Altoona	NNP
Published	VBN
Gene	NNP
zinc-air	NN
Kunimitsu	NNP
removal	NN
worker	NN
Fuel	NNP
Spanish	JJ
Using	VBG
mingled	VBD
quite	RB
gross	JJ
Bombay	NNP
predict	VBP
stood	VBD
lawyer	NN
Dutch	JJ
demand	NN
speak	VB
expect	VBP
Tripoli	NNP
Egyptian	JJ
substance	NN
done	VBN
cows	NNS
identified	VBN
shipbuilding	NN
hear	VB
agreeing	VBG
risen	VBN
unnecessary	JJ
depicted	VBN
policies	NNS
Corpus	NNP
Brazil	NNP
description	NN
-12-29-95	CD
Daniel	NNP
players	NNS
Salomon	NNP
11	CD
agricultural	JJ
originally	RB
photographs	NNS
Service	NNP
12-inch	JJ
sobering	VBG
flying	VBG
attended	VBN
Private	NNP
supersaturation	NN
Giat	NNP
Metals	NNP
July	NNP
liquid	JJ
MOST	NNP
decline	NN
-RRB-	-RRB-
financial	JJ
corners	NNS
treat	VB
copier	JJR
senators	NNS
however	RB
trends	NNS
Glasgow	NNP
sale	NN
clutching	VBG
2.5-liter	CD
cotton	NN
millions	NNS
fair-sized	JJ
newly	RB
Hudson-based	JJ
Rabta	NNP
proverb	NN
immigrants	NNS
unveil	VB
crop	NN
McCrary	NNP
chemists	NNS
Plan	NNP
Such	JJ
false	JJ
beneficial	JJ
Volvo	NNP
unfettered	JJ
daily	RB
Cloistered	VBN
Richland	NNP
mini-steel	NN
strong	JJ
decision	NN
happening	VBG
14	CD
Appleton	NNP
Clark	NNP
searchers	NNS
Processing	NNP
funds	NNS
Ford	NNP
squeeze	NN
lineup	NN
temperate	JJ
Today	NN
Cincinnati	NNP
performing	VBG
what	WP
floppy	JJ
Newall	NNP
parlors	NNS
Sport	NNP
wastes	NNS
BAY	NNP
digital	JJ
give	VB
Ankara	NNP
Wellington	NNP
leading	VBG
Sable	NNP
remedy	NN
warning	NN
enriched	JJ
deliberately	RB
dedicated	VBN
supports	VBZ
Regional	NNP
2p	CD
ratio	NN
Drayton	NNP
published	VBN
particular	JJ
represent	VB
City-area	NNP
testing	NN
crude	JJ
Long	NNP
offset	VBD
copies	NNS
bloc	NN
ruling	NN
briefly	RB
asexual	JJ
roofed	JJ
Manufacturing	NNP
Signs	NNS
Va.	NNP
firm	NN
ended	VBD
rooms	NNS
deserved	VBN
disrupted	VBN
printed-circuit	NN
proposal	NN
areas	NNS
angrily	RB
Ridley	NNP
C-17	JJ
Upjohn	NNP
113.3	CD
Y.W	NNP
import	VB
bacteria	NNS
operated	VBN
Fed	NNP
Maharashtra	NNP
Indian	JJ
Teamsters	NNPS
310	CD
whistleblower	NN
stance	NN
Atomic	NNP
Mackie	NNP
newspapers	NNS
37-year-old	JJ
Spa	NNP
Hostess	NNP
Collins	NNP
striving	VBG
No	DT
megawatts	NNS
chronic	JJ
60	CD
start-up	JJ
strategically	RB
89.9	CD
continue	VB
upgrade	VB
above-average	JJ
Daystrom	NNP
fritz	NN
recalled	VBN
balcony	NN
banker	NN
Workers	NNS
ca	MD
advance	VB
teaming	VBG
follow	VB
Ogoniland	NNP
causing	VBG
Kandel	NNP
11p	CD
flown	VBN
meter	NN
hazards	NNS
preferences	NNS
fissile	JJ
secretary	NN
lowest	JJS
role	NN
attractive	JJ
marks	NNS
lucrative	JJ
Staub	NNP
Calif.	NNP
summarizing	VBG
75	CD
mentioned	VBD
waste	NN
swore	VBD
statement	NN
light	JJ
450	CD
Hattori	NNP
latex	NN
search	NN
Empresa	NNP
wipe	VBP
162	CD
reactor	NN
dispute	NN
reactors	NNS
Berry	NNP
Mesa	NNP
test	NN
conclusion	NN
Ciudad	NNP
2-acre	JJ
speeches	NNS
re-establishing	NN
insects	NNS
Mexican	JJ
embryos	NNS
Taylor	NNP
titles	NNS
ahead	RB
believe	VBP
catalog	NN
Manaus	NNP
buyers	NNS
essential	JJ
outlook	NN
frankfurters	NNS
Amir	NNP
operators	NNS
Marcus	NNP
resisted	VBN
purchased	VBN
Boston-based	JJ
grind	VB
carbon-in-leach	JJ
army	NN
Lima	NNP
several	JJ
Been	VB
plot	NN
addressing	VBG
Dresser	NNP
washes	VBZ
supplying	VBG
feet	NNS
Gulotta	NNP
unionized	JJ
native	NN
having	VBG
vulnerable	JJ
Luigi	NNP
snow-laden	JJ
caustic	JJ
represents	VBZ
waves	NNS
Ala.	NNP
Cocaine	NNP
dynamic	JJ
stockpiles	NNS
43	CD
centers	NNS
admission	NN
abandoned	VBD
catch	VB
walking	NN
240	CD
Commonwealth	NNP
GM	NNP
Holgerson	NNP
Elena	NNP
helicopters	NNS
beefed	VBN
upward	RB
install	VB
whirlwind	NN
Adriatic	JJ
trebled	VBD
frame	NN
performance	NN
conscientious	JJ
766,000	CD
AlliedSignal	NNP
easy-to-ship	NN
diabetes	NNS
garment	NN
McCandless	NNP
585	CD
affirm	VB
department	NN
U.N.	NNP
show	VB
Seabrook	NNP
Rhode	NNP
formally	RB
steadily	RB
gardened	VBN
sends	VBZ
positions	NNS
company	NN
Expansion	NN
blends	NNS
1994	CD
pay	VB
Trades	NNP
picket	NN
contaminated	VBN
140	CD
Time-Life	NNP
carbide	NN
16.1	CD
owes	VBZ
49	CD
Augustow	NNP
gains	NNS
upgraded	VBN
six-acre	JJ
skilled	JJ
speech	NN
5.4	CD
905	CD
Tough	JJ
Institute	NNP
15.8	CD
Bilbao	NNP
complement	NN
center-left	JJ
boosting	VBG
Manitoba	NNP
already	RB
exports	NNS
packaging	NN
effective	JJ
mountain	NN
Interstate	NNP
improvements	NNS
currently	RB
corn	NN
rapid	JJ
active	JJ
actual	JJ
talent	NN
authorities	NNS
else	RB
position	NN
Yizheng	NNP
damp	JJ
8,000	CD
Netherlands	NNPS
groups	NNS
commitment	NN
sharply	RB
automated	JJ
Thousands	NNS
organic	JJ
climates	NNS
KU	NNP
regulatory	JJ
Bedek	NNP
52.5	CD
Zyrtec	NN
2.7	CD
acre	NN
specialized	JJ
2.8	CD
School	NNP
utility	NN
OPTIONAL	NNP
ITALY	NNP
seized	VBD
Zealand	NNP
insisted	VBD
scene	NN
heights	NNS
long	JJ
presented	VBD
intent	NN
electrician	NN
Baltimore	NNP
A.	NN
Toronto	NNP
branded	VBD
Croatia	NNP
-0-	.
725	CD
required	VBN
talks	NNS
map	NN
cashmere	JJ
women	NNS
provided	VBD
Eastman	NNP
sales	NNS
respiratory	NN
saying	VBG
Profits	NNS
negotiations	NNS
Pao	NNP
managing	VBG
mechanized	VBN
pork	NN
knows	VBZ
Grozny	NNP
Lake	NNP
nonculinary	JJ
NYT16	NNP
Cadillac	NNP
Power	NNP
element	NN
USG	NNP
hired	VBN
ailment	NN
hit	VBN
perfunctory	JJ
pathology	NN
grass	NN
McGregor	NNP
remains	VBZ
hill	NN
original	JJ
outer	JJ
in	IN
sage	NN
Yachiyo	NNP
LOCAL	NNP
using	VBG
packing	NN
Holdings	NNP
Anywhere	RB
mundane	JJ
aircrafts	NNS
Aoshima	NNP
25-megawatt	JJ
LL&E	NNP
autumn	NN
Tomen	NNP
warehouse	NN
model	NN
SEM	NNP
forced	VBN
said	VBD
Employees	NNS
Klots	NNP
just-expired	JJ
eggs	NNS
intervention	NN
monitors	NNS
Force	NNP
clients	NNS
small	JJ
ANGELES	NNS
unless	IN
SEATTLE	NN
resumed	VBD
patent	NN
polluted	JJ
Pollock	NNP
northern	JJ
legitimate	JJ
revised	VBN
cause	VB
annually	RB
42	CD
Fla	NNP
covered	VBN
Canton	NNP
severe	JJ
SKF	NNP
computer-stock	JJ
Moskvich	NNP
gothic	JJ
residing	VBG
ambush	VB
investments	NNS
weapons	NNS
Cedar	NNP
person	NN
wider	JJR
hell	NN
machines	NNS
Breyers	NNP
Chef	NNP
Ltd	NNP
differences	NNS
FRA	NNP
commission	NN
plots	NNS
peacemaking	NN
Bangor	NNP
payment	NN
benefits	NNS
developments	NNS
sitting	VBG
employer	NN
cuts	NNS
bridge	NN
St	NNP
Sakuma	NNP
weapon-grade	JJ
vice	NN
notebook	NN
notification	NN
Philips	NNP
get	VB
have	VBP
renegotiate	VB
algae	NN
criticized	VBN
mulling	VBG
Libyans	NNPS
Your	PRP$
trouble	NN
tires	NNS
battery	NN
ads	NNS
Neusch	NNP
competitors	NNS
attracted	VBN
photos	NNS
300,000-ton	JJ
crowding	VBG
Cirrus	NNP
go	VB
Australia	NNP
Cougars	NNP
altered	VBN
woman	NN
Mansfield-based	JJ
inspector	NN
Cornell	NNP
material	NN
met	VBN
vow	VB
depreciation	NN
Each	DT
chemical	NN
Sealtest	NNP
Magma	NNP
Delacruz	NNP
minivan	JJ
confirmed	VBD
plenty	NN
SpA	NNP
147	CD
Aircraft	NNP
machine	NN
muffler	NN
owner	NN
emphasize	VB
dig	VBP
Mound	NNP
loading	VBG
Lumina	NNP
Wirewound	NNP
devastating	JJ
drug	NN
Hyde	NNP
world	NN
think	VB
separated	VBN
1.9	CD
moved	VBD
days	NNS
basic	JJ
denounced	VBD
hand	NN
soda	NN
Division	NNP
O'Neal	NNP
mugs	NNS
quarters	NNS
boyhood	NN
Clack	NNP
Mun	NNP
Thanks	NNPS
week	NN
renewal	NN
pinatas	NNS
troops	NNS
bribes	NNS
speeds	NNS
asked	VBN
Bourke	NNP
Lomb	NNP
costs	NNS
mills	NNS
--and	JJ
layoff	NN
Col	NNP
learned	VBN
again	RB
navigation	NN
compared	VBN
relationship	NN
Wastewater	NNP
emerge	VBP
Worth	NNP
ago	RB
Mohegan-Sun	NNP
smitten	VBN
Amelio	NNP
moves	VBZ
31-year	JJ
mutant	JJ
19	CD
fiscal	JJ
full-year	JJ
bankruptcy	NN
contractor	NN
looks	VBZ
1,550	CD
35,000	CD
Sacramento	NNP
Supply	NN
cloth	NN
bioproduction	NN
plagued	VBN
start	VB
electricity	NN
Lynks	NNP
holds	VBZ
breast	NN
single	JJ
Enterprises	NNPS
powers	NNS
programs	NNS
falsify	VB
Venezuela	NNP
23	CD
suffocated	VBN
Wu-Lang	NNP
mothers	NNS
Shanghai	NNP
plutonium	NN
Rockland	NNP
Castrillo	NNP
Freios	NNP
shut-down	JJ
Middlesex	NNP
Atlanta	NNP
concrete	JJ
kit	NN
infant-formula	NN
aviary	NN
Menges	NNP
Peres	NNP
fatal	JJ
add	VB
immaculately	JJ
slaughterhouse	NN
ACTH	NNP
dim	JJ
Huxley	NNP
spinner	NN
analysis	NN
success	NN
Coastal	NNP
productivity	NN
ring	NN
V-6	NNS
East	NNP
racial	JJ
Mitterrand	NNP
technology	NN
opinion	NN
cylinders	NNS
S-MX	NNP
teething	VBG
opponent	NN
toll-free	JJ
tip	NN
owning	VBG
Rentokil	NNP
Fiat	NNP
meets	VBZ
phytochemicals	NNS
47	CD
Stark	NNP
brother	NN
further	RBR
members	NNS
compact	JJ
Paris	NNP
Tucson	NNP
-02-20-96	CD
distillation	NN
Wisconsin-based	JJ
post-partum	JJ
none	NN
Sprint	NNP
serial	JJ
flag	NN
frantically	RB
architectural	JJ
Nobuhiro	NNP
LaMott	NNP
preferred	VBD
clues	NNS
accountant	NN
antipollution	JJ
Makban	NNP
Rocky	NNP
Electronics	NNP
computer-controlled	JJ
Tribasa	NNP
half-hour	NN
Trigg	NNP
Rome	NNP
eight-inch	JJ
alone	RB
His	PRP$
Nien	NNP
conjunction	NN
Angping	NNP
booming	JJ
transportation	NN
cactus-like	JJ
Party	NNP
maneuvering	NN
NU	NNP
Joong	JJ
Robotics	NNP
their	PRP$
IAI	NNP
nor	CC
Democrats	NNPS
fast-growing	JJ
Mindanao	NNP
86	CD
Asarco	NNP
rare	JJ
Wayne	NNP
favorite	JJ
reveal	VB
legacy	NN
knives	NNS
it	PRP
votes	NNS
N.Y	NNP
inspection	NN
operates	VBZ
March	NNP
flower	NN
actually	RB
gave	VBD
declare	VB
Industries	NNPS
660,000	CD
Loxley	NNP
high	JJ
Rayong	NNP
Studying	NNP
oven	JJ
reorganizing	VBG
NV	NNP
Bausch	NNP
target	NN
converting	VBG
listen	VB
became	VBD
solid-waste	NN
marvel	NN
Caracas	NNP
gushed	VBD
managers	NNS
dioxin	NN
UN	NNP
radical	JJ
admitted	VBD
clashing	NN
delay	VB
1963	CD
Procter	NNP
unusually	RB
Bloomfield	NNP
ordered	VBN
rates	NNS
jury	NN
promise	NN
crows	NNS
memory-chip	NN
Innocent	NNP
endangered	VBN
1970	CD
Portland	NNP
truckish	JJ
thousands	NNS
2-year-old	JJ
prepared	VBN
GER	NNP
forefront	NN
Sunday	NNP
1986	CD
insect	JJ
accurately	RB
shortly	RB
Daschle	NNP
George	NNP
Dothan	NNP
clicked	VBD
let	VB
personally	RB
story	NN
Conoco	NNP
carry	VBP
GE	NNP
satellites	NNS
structural	JJ
chilly	JJ
Anchor	NNP
Freeport	NNP
Tosco	NNP
trim	JJ
Werhan	NNP
Brookhaven	NNP
surged	VBN
hog	NN
Peregrine	NNP
black	JJ
N.C.	NNP
cruising	VBG
FARM	NNP
room-sized	JJ
perceive	VB
tradition	NN
petrochemical	NN
universal	JJ
conduit	NN
anti-aircraft	JJ
worsen	VB
chairman	NN
reconfigure	VB
BEAR	IN
Manufacturers	NNPS
stabilizing	VBG
sheet	NN
gleaming	VBG
taxpayer-financed	JJ
Romo	NNP
factors	NNS
Patrick	NNP
55	CD
zoo	NN
at	IN
L1V	NNP
port	JJ
Lopez	NNP
extended	VBN
Life	NNP
FORT	NNP
Technology	NNP
firsthand	JJ
--before	JJ
grounds	NNS
all-white	JJ
Territory	NNP
disputed	VBD
often	RB
managed	VBD
apart	RB
delays	VBZ
details	NNS
Armand	NNP
infrastructure	NN
welcomed	VBN
write-off	NN
pilot	NN
quickly	RB
PEPPER-COX-CLR	NN
some	DT
Pat	NNP
Mexico	NNP
UK	NNP
handsets	NNS
200	CD
top-secret	JJ
Biogen	NNP
Laboratories	NNP
locoweed	NN
billion-pound	JJ
reportedly	RB
audiences	NNS
accident	NN
brush	NN
standards	NNS
waxy	JJ
dollar	NN
close	VB
bother	VB
Frenchy	NNP
Richmond	NNP
Forte	NN
each	DT
fairly	RB
grim	JJ
688	CD
Maynard-based	JJ
pool	NN
Parker	NNP
increased	VBN
Committee	NNP
Davis	NNP
advocates	VBZ
U.K.	NNP
4.5	CD
Utah	NNP
cheeks	NNS
begin	VB
Oshawa	NNP
turning	VBG
wholly	RB
Township	NNP
Rosslyn	NNP
fuel	NN
unions	NNS
opens	VBZ
ATLANTA	NNP
Victor	NNP
division	NN
Walsh	NNP
windfall	NN
34-year-old	JJ
ignore	VB
involving	VBG
Alberta	NNP
consolidations	NNS
jams	NNS
550	CD
properly	RB
jealous	JJ
Place	NNP
Chirac	NNP
tries	VBZ
reject	VBP
Wisconsin	NNP
Milken	NNP
Albany	NNP
relies	VBZ
declared	VBD
crimped	VBN
settlement	NN
tub	NN
Midland	NNP
tests	NNS
finalists	NNS
evoke	VB
contend	VBP
Tarxien	NNP
throttle	JJ
Union	NNP
lower	JJR
connections	NNS
123	CD
crisp	JJ
Scivetti	NNP
Harris	NNP
IRC	NNP
trend	NN
buildings	NNS
A$	$
Department	NNP
Ing	NNP
Update	NNP
Keep	VB
ginger	NN
floor	NN
goes	VBZ
Berman	NNP
stand	NN
soup-red	JJ
Francisco	NNP
packaged	VBN
prompted	VBD
retail	JJ
meat-packing	JJ
18-inch	JJ
Pu-238	NN
hydroelectric	JJ
Parry	NN
Gamble	NNP
distributes	VBZ
light-wood	JJ
memorandums	NNS
danger	NN
inefficient	JJ
entered	VBN
signal	NN
Vera	NNP
farmers	NNS
Challenge	NNP
Tillman	NNP
deliver	VBP
111.9	CD
meters	NNS
angel	NN
now-closed	JJ
Normal	NNP
scientific	JJ
humans	NNS
set	VBD
Including	VBG
Nevada	NNP
Moreover	RB
closely	RB
heap	NN
got	VBD
communities	NNS
Polar	NNP
Co.	NNP
ADI	NNP
Petronas	NNP
leadership	NN
sewer	NN
interested	JJ
polycarbonates	NNS
rugged	JJ
her	PRP$
lite	NN
employed	VBN
Avalons	NNP
conspiring	VBG
Casinos	NNS
Anna	NNP
Clearwater	NNP
Fairfax	NNP
Garcia	NNP
stands	VBZ
civilization	NN
host	NN
sheets	NNS
6.90	CD
approves	VBZ
Beijing	NNP
largest	JJS
Tower	NNP
Ind	NNP
orders	NNS
suggesting	VBG
St.	NNP
reduced	VBD
cells	NNS
inaugurated	VBD
nights	NNS
eventual	JJ
death	NN
runs	VBZ
Morgan	NNP
explain	VB
21	CD
4	CD
Kankakee	NNP
N.J	NNP
acted	VBN
prevent	VB
'	POS
Moerdyk	NNP
foreign	JJ
want	VBP
isoflavonoids	NNS
Rossco	NNP
arrived	VBD
Ltd.	NNP
hushed	VBN
too	RB
off	RP
pepper	NN
sit	VB
100-year-old	JJ
sleek	JJ
peaks	NNS
RISKS	NNP
farms	NNS
lose	VB
Cherry	NNP
locked	VBN
championed	VBN
sunglasses	NNS
lowers	VBZ
streams	NNS
agents	NNS
Ben	NNP
waste-water	JJ
praying	VBG
ammunition	NN
trial	NN
sentencing	NN
seeing	VBG
demonstrations	NNS
731	CD
Chinese	JJ
emloyees	NNS
ongoing	JJ
involves	VBZ
slowly	RB
Elsie	NNP
more	JJR
shooting	NN
Pneumatic	NNP
protested	VBD
difficulty	NN
formula	NN
Carpet	NNP
Caledonia	NNP
half	NN
arch-rival	NN
800	CD
Minn.	NNP
miles	NNS
Stride	NNP
antiquated	VBN
warehousing	NN
boost	VB
Lignum-vitae	NNP
made-in-America	JJ
tripod	NN
Amstrad	NNP
Fokker	NNP
cargo	NN
review	VB
urged	VBN
2,300	CD
difficult	JJ
Rather	RB
proceed	VB
212	CD
Southern	NNP
blizzard	NN
types	NNS
Belle	NNP
tropical	JJ
dead	JJ
thorny	JJ
E.	NNP
Real	NNP
Petrochemical	NNP
cursed	VBN
anti-allergy	JJ
billion	CD
Bernard	NNP
2.5	CD
has	VBZ
even	RB
Moore	NNP
salts	NNS
mail	NN
braving	VBG
communications	NNS
longtime	JJ
Weiss	NNP
participate	VB
Calabarzon	NNP
fish-processing	JJ
Hopp	NNP
Bank	NNP
Bremen	NNP
sparked	VBN
Studies	NNPS
gas-fired	JJ
wages	NNS
government-owned	JJ
income	NN
1.6	CD
tablets	NNS
Dan	NNP
Hanny	NNP
foothold	NN
trims	NNS
night	NN
A$0.9	CD
out	RP
vehicles	NNS
:	:
dominant	JJ
Safety	NNP
Milwaukee	NNP
operation	NN
avoid	VB
brand	NN
Savannah	NNP
Mich	NNP
Detlef	NNP
pure	JJ
BONEYARD	NNP
150	CD
red-tape	JJ
Colombia	NNP
Chumash	NNP
braking	NN
freedom	NN
CA	NNP
chemical-processing	NN
positioning	NN
introduces	VBZ
BMW	NNP
bathrooms	NNS
waiting	VBG
export	NN
shores	NNS
OUT	NNP
is	VBZ
popular	JJ
Finnegan	NNP
staff	NN
oriented-polypropylene	NN
NYT7	NNP
air-conditioning	NN
process	NN
weekly	JJ
Cape	NNP
term	NN
critical	JJ
Tuen	NNP
pricing	NN
shown	VBN
Conn	NNP
surface	NN
Johannesburg	NNP
megawatt	NN
exchanges	NNS
occurs	VBZ
72	CD
easily	RB
shuttering	VBG
Pretoria	NN
Botanic	NNP
Rock	NNP
WASHINGTON	NNP
persuaded	VBN
:43	CD
million-a-year	JJ
still	RB
Dhia	NNP
invite	VB
torn	VBN
End	NN
shampoo	NN
Unlike	IN
perfect	JJ
wholesale	JJ
Contour-Mystique	JJ
350-megawatt	JJ
13,000	CD
modern	JJ
India	NNP
issue	NN
Authorities	NNS
Nassau	NNP
impossible	JJ
road	NN
resident	NN
approval	NN
Pradesh	NNP
curtail	VB
82.8	CD
land	NN
Surf	NNP
Schori	NNP
Snohomish	NNP
lent	VBN
issues	NNS
protectionist	NN
Aerospace	NNP
n't	RB
cigarettes	NNS
Holsum	NNP
Somebody	NN
impasse	NN
Taiwan	NNP
Newton	NNP
meat	NN
phrases	NNS
Eugenio	NNP
Augat	NNP
&	CC
quadrant	NN
demanding	VBG
92	CD
Eagle	NNP
Aguazul	NNP
immediately	RB
explorer	NN
site	NN
GPU	NNP
near	IN
although	IN
scurry	VBP
lift	VB
owners	NNS
RET	NNP
top-to-bottom	JJ
doubts	NNS
200,000	CD
Botanical	NNP
crops	NNS
Philadelphia	NNP
Information	NNP
CD-ROM	JJ
scaled	VBD
`deplores	NNS
negotiate	VBP
reaches	VBZ
edge	NN
Joliet	NNP
refund	NN
Bright	NNP
corroding	VBG
highest	JJS
tripled	VBD
deductible	JJ
Crews	NNS
Medfly	NNP
urban	JJ
full	JJ
Kalahari	NNP
Werner	NNP
bound	VBN
predecessors	NNS
Segundo	NNP
outskirts	NNS
second	JJ
Lexington	NNP
Charvat	NNP
apprentice	NN
commander	NN
earlier	RB
situation	NN
assemble	VB
see	VB
mid-January	NNP
she	PRP
Matsushita	NNP
defendants	NNS
4.5-liter	NN
source	NN
Like	IN
revival	NN
humanize	VB
NT$	NNP
lioness	NN
fair	JJ
Senate	NNP
300	CD
1948EST	CD
cancer	NN
swallow	VB
alike	RB
mountainside	NN
creates	VBZ
cramped	JJ
yesterday	NN
visit	NN
structures	NNS
Deere	NNP
12,450	CD
molasses	NNS
vital	JJ
treatment	NN
monitor	VB
Herman	NNP
Shoeburyness	NN
Arabian	NNP
Primack	NNP
OF	IN
Eugene	NNP
arm	NN
overassessment	NN
links	NNS
manufacture	VB
sinister	NN
carbon	NN
four-door	JJ
sanctions	NNS
modems	NNS
-RSB-	JJ
estimates	NNS
plow	VB
Our	PRP$
restructuring	NN
papyrus	NN
rodeo	NN
departures	NNS
Nursoy	NNP
36	CD
keeping	VBG
long-mothballed	JJ
Zimmerman	NNP
trees	NNS
injuring	VBG
vanish	VB
Greig	NNP
boots	NNS
Some	DT
facility	NN
erupted	VBD
Pepsico	NNP
spiraled	VBD
Electrica	NNP
likely	JJ
visions	NNS
Xu	NNP
shut	VBN
bearing	NN
hedges	NNS
Hindu	NNP
Bradley	NNP
prices	NNS
conveyor	NN
retirement	NN
studios	NNS
negotiated	VBN
MAN	NNP
bit	NN
privately	RB
emits	VBZ
winters	NNS
Marubeni	NNP
thermoelectric	JJ
Stuttgart	NNP
manner	NN
effort	NN
unlikely	JJ
located	VBN
edition	NN
mechanical	JJ
evade	VB
K.	NNP
send	VBP
radioisotope	NN
Cat	NNP
8	CD
complain	VBP
Fernandez	NNP
of	IN
Company	NN
Instrument	NNP
consumers	NNS
General	NNP
Motoren	NNP
worried	VBN
Alaska	NNP
prairie	NN
nation	NN
Eickman	NNP
Mitsubishi	NNP
evacuate	VB
maker	NN
census	NN
figures	NNS
improved	JJ
rests	VBZ
report	NN
five	CD
nickel	NN
pensions	NNS
Doraville	NNP
Ilo	NNP
4.46	CD
national	JJ
utilities	NNS
Gainesville	NNP
brief	JJ
split	VB
country	NN
cats	NNS
tequila	NN
shares	NNS
into	IN
toy-making	JJ
apologize	VB
Wheeler	NNP
custodian	NN
Santana	NNP
Thailand-Malaysia	NNP
Industrial	NNP
Loreen	NNP
Seward	NNP
Cala	NNP
Casanare	NNP
Brasileiras	NNP
pleading	VBG
chopped	VBN
swallowed	VBD
months	NNS
Lydia	NNP
monument	NN
intimidating	VBG
helicopter	NN
precautions	NNS
violation	NN
makes	VBZ
Bingaman	NNP
circulation	NN
White	NNP
mining	NN
conventional	JJ
all	DT
abortion	NN
trait	NN
gum	NN
wheat	NN
dignitaries	NNS
Chip	NN
departments	NNS
blame	VB
finance	NN
Grumman	NNP
boxes	NNS
Kills	NNPS
Joseph	NNP
snowy	JJ
1939	CD
town	NN
CLINTON	NNP
why	WRB
cure	NN
object	VBP
giant	JJ
politicians	NNS
Pedro	NNP
biodiversity	NN
Bacardi	NNP
disputes	NNS
basis	NN
PC	NN
woes	NNS
Mickey	NNP
aid	NN
chance	NN
perfume-bottle	NN
dizzying	JJ
Also	RB
accomplishments	NNS
climbed	VBD
Ericsson	NNP
towers	NNS
specialization	NN
unfinished	JJ
chrome-plated	JJ
Single	NNP
unknown	JJ
in-depth	JJ
station	NN
Marcel	NNP
Mercury	NNP
personnel	NNS
conditions	NNS
transmission	NN
primary	JJ
section	NN
periodically	RB
1941	CD
bring	VB
consultant	NN
335	CD
stick	VB
McFall	NNP
Ametec	NNP
:20	CD
collector	NN
techniques	NNS
31	CD
emergency	NN
phones	NNS
Sayles	NNP
Samsonite	NNP
bypass	VB
suburban	JJ
duct	NN
decreed	VBN
Corporation	NNP
defense	NN
assisting	VBG
Jan/16/96	NNP
eating	VBG
headquarters	NN
JAMES	NNP
1979	CD
chicken	JJ
pollution	NN
dramatically	RB
Beit	NNP
inflame	VB
he	PRP
Wall	NNP
Acer	NNP
corrected	VBN
synthetic	NN
squabbling	VBG
1974	CD
upstream	NN
mysterious	JJ
LOS	NNP
raising	VBG
animal	NN
Utility	NNP
sources	NNS
crew	NN
1,000-acre	JJ
Castle	NNP
ceased	VBN
shakeout	NN
province	NN
camper	NN
dealers	NNS
sclerosis	NN
holding	VBG
grains	NNS
She	PRP
Hoechst	NNP
Minneapolis	NNP
defeated	VBN
Times	NNP
Ithaca	NNP
Focusing	VBG
controlled	VBN
Seventh	NNP
Virginia	NNP
Parsons	NNS
expedite	VB
suits	NNS
protection	NN
USDA	NNP
lipstick	NN
80,000	CD
Generating	NNP
Small	JJ
77	CD
Cliffside	NNP
Eligio	NNP
1270	CD
retain	VB
clerks	NNS
Saturn	NNP
20	CD
visitor	NN
emergent	NN
shrimp-feed	NN
Cantrail	NNP
defense-electronics	JJ
water-soluble	JJ
neighbors	NNS
Edmund	NNP
Alabama	NNP
shop	NN
convinced	JJ
96	CD
Richman	NNP
Jeronimo	NNP
conversion	NN
Poznan	NNP
guarded	VBN
laptops	NNS
booms	NNS
filling	VBG
've	VBP
Sanitation	NNP
standard	NN
2-to-1	JJ
transforming	VBG
Barranquilla	NNP
bad	JJ
500-million-mark	JJ
Jalisco	NNP
markets	NNS
4,500	CD
seemed	VBD
Retired	JJ
locale	NN
did	VBD
fleeing	VBG
Naples	NNP
Perez	NNP
645	CD
EDF	NNP
thousand-year-old	JJ
rose	VBD
pipeline	NN
Shemesh	NNP
offices	NNS
400	CD
decide	VBP
Federal	NNP
violations	NNS
sacred	JJ
makers	NNS
gates	NNS
outlining	VBG
Macedonia	NNP
6.25	CD
exclusively	RB
recycling	NN
freezers	NNS
Cos.	NNP
limping	VBG
Vizcaya	NNP
polyolefins	NNS
tore	VBD
2.77	CD
Internet	NNP
Guam	NNP
Rowe	NNP
Andersz	NNP
consistent	JJ
21st	JJ
throughout	IN
Crisoba	NNP
PowerPC	NNP
58	CD
attract	VB
pitched	VBD
rolling	NN
Tempo	NNP
Joe	NNP
promoting	VBG
interests	NNS
Jr.	NNP
1,200	CD
Never	RB
Toshiba	NNP
spoke	VBD
radio	NN
Missouri-based	NNP
ethane	NN
obvious	JJ
agriculture	NN
Lorain	NN
balance	NN
moment	NN
microprocessors	NNS
bar	NN
nationalism	NN
deciding	VBG
stage	NN
assembled	VBN
Bromont	NNP
Robledo	NNP
clean	JJ
Good	JJ
Dottie	NNP
true	JJ
hauler	NN
Bochum	NNP
push	VB
5	CD
continues	VBZ
Malaysian	JJ
one-year	JJ
34	CD
delivering	VBG
board	NN
Clinton	NNP
Ha'emek	NNP
fighters	NNS
referred	VBN
Telles	NNP
Many	JJ
US$	$
policy	NN
James	NNP
inflating	VBG
Connecticut-based	JJ
media	NNS
Reports	NNS
appearance	NN
Western-made	JJ
five-year	JJ
initial	JJ
variously	RB
Health	NNP
product	NN
Hadron	NNP
cleaning	VBG
59	CD
helped	VBD
Instead	RB
president	NN
Farmers	NNP
Chamber	NNP
moonshine	JJ
recently	RB
EPA	NNP
US	PRP
1951	CD
Bolivar	NNP
250	CD
stocky	JJ
feature	VB
Christmas	NNP
produced	VBN
appeal	NN
couple	NN
dropped	VBD
multiple	JJ
faces	VBZ
crucial	JJ
four-story	JJ
Unis	NNP
Alliance	NNP
Geneva	NNP
which	WDT
shuts	VBZ
anger	NN
Buchanan	NNP
collateral	NN
River	NNP
through	IN
Programs	NNP
package	NN
potted	JJ
opportunity	NN
casinos	NNS
Dotter	NNP
Jeremy	NNP
face	NN
police	NN
gives	VBZ
built	VBN
auto-parts	NNS
mid-1970s	NNS
Farms	NNP
boom	NN
Nomura	NNP
amole	NN
excessive	JJ
settle	VB
occurred	VBD
Qjobs	NNS
logging	NN
Minh	NNP
1,850	CD
examined	VBN
drifts	NNS
DOE	NNP
combustion	NN
allocate	VB
Local	JJ
hour	NN
dismantlement	NN
discharges	VBZ
expenses	NNS
alleged	VBN
month	NN
backed	VBN
Mayak	NNP
already-announced	JJ
vase	NN
competitive	JJ
thrown	VBN
3.5	CD
challenged	VBN
Formosa	NNP
incinerator	NN
Tyson	NNP
Kamma	NNP
30-year-old	JJ
Queens	NNP
water-discharge	JJ
matter	NN
Ralph	NNP
reconstituted	JJ
easing	VBG
Cyberlane	NNP
triangular	JJ
completely	RB
Pickett	NNP
thanks	NNS
housing	NN
Nashville	NNP
anxious	JJ
large	JJ
accusing	VBG
Saha-Union	NNP
trail	NN
upon	IN
daylong	JJ
NEC	NNP
Legislature	NNP
court	NN
act	NN
Other	JJ
weigh	VB
marketing	NN
prime	JJ
Scott	NNP
lunch-bucket	NN
outplacement	NN
tonight	RB
seats	NNS
indefinitely	RB
Depression	NN
60-year-old	JJ
Wood	NNP
masquerading	VBG
Na-Bolom	NN
Luzon	NNP
leaked	VBN
Hawkins	NNP
cranked	VBD
Over	IN
Oakland	NNP
3,200	CD
rubble	NN
Ever	RB
smaller	JJR
wore	VBD
Constructors	NNPS
thinly	RB
11.9	CD
Wright	NNP
supplier	NN
Terquem	NNP
breathtakingly	RB
eight	CD
botany	NN
cafeteria	NN
jetmaker	NN
CCA	NNP
Hanoi	NNP
JUS	NNP
paid	VBD
1.4	CD
lack	NN
if	IN
3	CD
refueled	VBN
generate	VB
culture	NN
What	WP
Gadhafy	NNP
parked	VBN
hauling	NN
Cowen	NNP
...	:
heading	VBG
American	JJ
crash	NN
seem	VBP
permissible	JJ
Guaiacum	NNP
claiming	VBG
1858	CD
representing	VBG
67.6	CD
purchases	NNS
Kinzoku	NNP
IMAGE	NNP
pieces	NNS
instruments	NNS
earful	JJ
visiting	VBG
measurements	NNS
changes	NNS
Commission	NNP
's	POS
consortium	NN
locally	RB
second-quarter	JJ
vegetable	JJ
7.50	CD
within	IN
emissions	NNS
Oxford	NNP
Hyundai	NNP
sparkling	VBG
UtiliCorp	NNP
Callan	NNP
46	CD
landed	VBN
During	IN
sixth-most-watched	JJ
restraints	NNS
specimens	NNS
able	JJ
financing	NN
winter	NN
200-year	JJ
Mrs.	NNP
Wading	NNP
Gradiente	NNP
Bajaj	NNP
showed	VBD
based	VBN
alarmed	VBN
Cuba	NNP
Bahia	NNP
Named	VBN
All	DT
repeatedly	RB
woody	NN
Cia	NNP
Bothel	NNP
10,000	CD
hatchery	NN
federation	NN
Whatever	WDT
divide	NN
WMC	NNP
him	PRP
assumed	VBN
Ogoni	NNP
lighter	JJR
215-megawatt	JJ
traders	NNS
ordnance	NN
bolster	VB
tea	NN
VAN	NNP
ceremony	NN
few	JJ
Kraft	NNP
fourth-quarter	JJ
strike	NN
Yard	NNP
4th-qtr	JJ
72-inch	JJ
structure	NN
organizers	NNS
completion	NN
phenolic	JJ
party	NN
sixth-grade	JJ
serious	JJ
motor	NN
Ranger	NNP
nearby	JJ
Elmo	NNP
isothiocyanates	NNS
probing	VBG
co-owner	NN
Celanese	NNP
assistance	NN
interviewed	VBD
sympathize	VB
showing	VBG
measure	NN
place	NN
building	VBG
Ala	NNP
ISDN	NNP
Starbucks	NNP
professor	NN
Dutch/Shell	NNP
obtained	VBD
Sherrit	NNP
Middleton	NNP
spelling	JJ
Choice	NNP
cracking	NN
apparel	NN
FIRST	NN
Dec.	NNP
affidavit	NN
interfered	VBD
gnatcatcher	NN
quote	NN
BMW-Austria-Group	NN
growth	NN
Network	NNP
Boone	NNP
handle	VB
190,000-barrel-a-day	JJ
abolish	VB
London	NNP
guides	NNS
world-class	JJ
64-megabit	JJ
icing	JJ
magazines	NNS
anything	NN
aired	VBD
believes	VBZ
cameras	NNS
Dallas-based	JJ
first-half	JJ
16.8	CD
Dutch-based	JJ
entire	JJ
Hazlehurst	NNP
Inc	NNP
highlighting	VBG
relieve	VB
Jimmy	NNP
putters	NNS
aerospace	NN
Louis	NNP
Length	NNP
Manmohan	NNP
PDVSA	NNP
lab	NN
occupies	VBZ
Press	NNP
irrelevant	JJ
artists	NNS
Seductive	JJ
Nanjing	NNP
Reservoir	NNP
Pharmacia	NNP
silicon-wafer	NN
meet	VB
ripple	JJ
Naval	NNP
member	NN
U.S.-based	JJ
Dickensian-feel	NNP
twist	NN
L.	NNP
Warner	NNP
builders	NNS
record	NN
Emporium	NN
tactics	NNS
candidates	NNS
distinctly	RB
willing	JJ
theirs	PRP
pots	NNS
Electricity	NNP
Swiss-based	JJ
employee	NN
wrought	JJ
than	IN
startling	JJ
27.8	CD
Syracuse	NNP
35	CD
move	NN
roots	NNS
Madison	NNP
Andrew	NNP
food	NN
they	PRP
expanded	VBN
Accountability	NNP
bothered	VBN
six	CD
working-class	JJ
AVIC	NNP
table-salt-sized	JJ
Bombardier	NNP
earned	VBD
winning	VBG
4.75-an-hour	JJ
downtime	NN
tropicals	NNS
Laborers	NNP
hearing	NN
blanks	NNS
Four	CD
successfully	RB
NRC	NNP
resembled	VBD
punish	VB
Houston	NNP
breast-implant	JJ
breasts	VBZ
prove	VB
wrapped	VBN
amounts	NNS
rust-proofing	NN
threatens	VBZ
shiny	JJ
health	NN
living	VBG
nine	CD
Iowa	NNP
appointed	VBN
reap	VB
fattened	VBN
surrounding	VBG
Ives	NNPS
LG	NNP
pickup	NN
vote	NN
congressmen	NNS
3C	NNP
encasing	VBG
Belt	NNP
college	NN
no-strike	JJ
steals	NNS
Similarly	RB
Forest	NNP
Several	JJ
Los	NNP
cover	VB
28.3	CD
Ulric	NNP
130	CD
citizens	NNS
suburb	NN
Next	NNP
Hiroshima	NNP
forward	RB
ancestral	JJ
impacts	NNS
Board	NNP
destiny	NN
Henry	NNP
informed	VBN
disposes	VBZ
yards	NNS
century	NN
reopening	VBG
2.	CD
divert	VB
dismayed	VBN
parade	NN
evaporation	NN
Rochester	NNP
900	CD
Capital	NNP
shared	VBN
Bitumenes	NNPS
way	NN
Mln	CD
seed	NN
AT&T	NNP
boards	NNS
scoop	VBP
Center	NNP
falling	VBG
analyst	NN
seemingly	RB
Shirt	NNP
Garden	NNP
little	JJ
acquired	VBN
colorful	JJ
long-term	JJ
Rite	NNP
materials	NNS
reporters	NNS
Most	JJS
Side	NNP
escaping	VBG
long-standing	JJ
hinged	VBN
stretched	VBD
Zhuhai	NNP
sample	NN
perch	NN
interest	NN
containers	NNS
Aurora	NNP
F-15	NN
evening	NN
pending	VBG
wage	VB
7,631	CD
persons	NNS
foes	NNS
occasional	JJ
aluminum	NN
Separately	RB
available	JJ
McIntire	NNP
dried	JJ
remained	VBN
Associates	NNP
Warren	NNP
Engine	NNP
Lugar	NNP
competition	NN
securitization	NN
utilizing	VBG
that	IN
Aquitaine	NNP
Group	NNP
coupes	NNS
Public	NNP
ramped	VBN
slips	VBZ
William	NNP
Council	NNP
salespeople	NN
Gasoline	NNP
10,357	CD
safe	JJ
reopened	VBN
turned	VBD
Henderson	NNP
academy	NN
Lynda	NNP
prepayments	NNS
change	NN
processing	NN
Special	NNP
tools	NNS
product-design	JJ
17-mile	JJ
white	JJ
caucuses	NNS
3.05	CD
Taystee	NNP
giving	VBG
Instruments-Acer	NNP
neglect	NN
rural	JJ
sections	NNS
36-hour	JJ
truth	NN
empty	VB
estimated	VBN
walls	NNS
U.S.	NNP
earth	NN
highly	RB
Johnson	NNP
petrochemicals	NNS
May	NNP
Carthage	NN
photograph	NN
simplified	VBD
campaigning	NN
bottles	NNS
indicated	VBD
Ken	NNP
examine	VBP
1/4	CD
recouped	VBN
missionary	JJ
Intel	NNP
blooming	NN
Suffolk	NNP
inch	NN
Marshalltown	NNP
Nokia	NNP
render	VB
Amarillo	NNP
investing	VBG
restricted	VBN
rip	NN
U	NNP
Bitor	NNP
inspect	VB
cinder-block	JJ
pleaded	VBD
generally	RB
bulletproof	JJ
Arabia	NNP
walked	VBD
agar	NN
labor	NN
bomb-grade	NN
Globo	NNP
I	PRP
action	NN
know	VB
sensors	NNS
a.m	RB
affect	VB
mission	NN
across	IN
Gordon	NNP
could	MD
cars	NNS
soared	VBD
radar	NN
receive	VB
due	JJ
Merlyn	NNP
copper	NN
Coalition	NN
finally	RB
revived	VBN
decommissioning	NN
earmarked	VBN
partner	NN
Gary	NNP
consideration	NN
Snack	NNP
350,000	CD
Office	NNP
surprise	VB
claimed	VBD
kilometers	NNS
by	IN
RELAP5YA	NNP
vacuum-packing	JJ
Belmont	NNP
endorsed	VBN
Pistorio	NNP
modernized	VBN
emission-control	JJ
75th	JJ
revamp	VB
artist	NN
observed	VBN
senator	NN
Coast	NNP
arrangements	NNS
formulas	NNS
422	CD
expand	VB
sudden	JJ
Griffin	NNP
layoffs	NNS
cents	NNS
boat	NN
wave	NN
information	NN
dozens	NNS
operational	JJ
tariffs	NNS
From	IN
subsidiary	NN
Santa	NNP
view	NN
studying	VBG
red	JJ
60-acre	JJ
defenders	NNS
arises	VBZ
entailed	VBD
scores	NNS
Manhattan	NNP
Ventura	NNP
Qilu	NNP
current	JJ
Dave	NNP
adequate	JJ
proceedings	NNS
hottest	JJS
Its	PRP$
60-inch	JJ
thrive	VBP
previous	JJ
Kaohsiung	NNP
Man	NNP
hardware	NN
Sarcoxie	NNP
Palo	NNP
tree	NN
Plant	NNP
fitting	VBG
tool	NN
pilgrimage	NN
producer	NN
trustees	NNS
discussion	NN
rid	JJ
Haiti	NNP
cover-ups	NNS
magical	JJ
venture	NN
weakening	VBG
jointly	RB
scrape	NN
VDMA	NNP
everyone	NN
almonds	NNS
nutrient	NN
Oregan	NNP
Please	NN
3.4	CD
ranging	VBG
Indonesia	NNP
truck	NN
drawings	NNS
butts	NNS
0.78	CD
breeders	NNS
slower	JJR
non-nutrients	NNS
illegally	RB
passenger-car	NN
liquid-helium	NN
goods	NNS
economies	NNS
questions	NNS
Vitasoy	NNP
Nikon	NNP
Yun	NNP
oranges	NNS
job	NN
was	VBD
connecting	VBG
Products	NNPS
socket	NN
businesses	NNS
pirated	JJ
color	NN
sides	NNS
phasing	VBG
ulcer	NN
Valley	NNP
chemicals	NNS
plutonium-fueled	JJ
passed	VBN
--economists	NNS
overall	JJ
establish	VB
claims	NNS
trillion	CD
massive	JJ
debate	NN
More	JJR
profitably	RB
strength	NN
supported	VBN
Everglades	NNS
Delgado	NNP
spokesman	NN
neak	NN
Campbell	NNP
600	CD
views	NNS
Tequila	NNP
shoulder-to-shoulder	NN
Metal	NNP
lieu	NN
elevator	NN
prostrate	NN
forecast	VBN
restructure	VB
Danbury	NNP
pledged	VBN
Route	NNP
immersed	VBN
Jan.	NNP
toward	IN
rise	NN
curl	JJ
291.77	CD
Gail	NNP
Chandler	NNP
expected	VBN
Zone	NNP
unit	NN
linking	VBG
engineers	NNS
Andover	NNP
Floatmaster	NN
Morris	NNP
600-megawatt	JJ
Bosnia-Herzegovina	NNP
discussions	NNS
479	CD
public	JJ
noted	VBD
Mines	NNP
Eastern	NNP
trolley-car	NN
Tuas	NNP
combined	JJ
bits	NNS
HEADLINE	NNP
project	NN
CMS	NNP
helping	VBG
invest	VB
systems	NNS
Gains	NNS
BILL	NNP
Desjonqueres	NNP
sport-utility	NN
ecology	NN
solidifies	VBZ
smelter	NN
ensure	VB
forgotten	VBN
authority	NN
inevitably	RB
Guayana	NNP
100	CD
Anthony	NNP
south	RB
ambitious	JJ
six-cylinder	NN
force	NN
exceed	VB
Particle	NNP
Yorkers	NNPS
Confederation	NN
belts	NNS
3,500	CD
mined	VBN
separate	JJ
Cuomo	NNP
Until	IN
United	NNP
introduced	VBD
Huggins	NNP
terminals	NNS
factories	NNS
dumped	VBD
switched	VBD
Vietnam	NNP
favored	VBN
beans	NNS
Nonetheless	RB
Park	NNP
chocolate	NN
Imports	NNS
missile	NN
Gemsbok	NNP
investigating	VBG
film	NN
era	NN
bashing	NN
proposed	VBN
future	NN
S	NNP
broken	JJ
560	CD
clean-water	JJ
Gramm	NNP
Smyrna	NNP
first	JJ
old	JJ
:02	CD
faded	VBD
sealed	VBN
allowed	VBN
foods	NNS
ten	JJ
We	PRP
225,000	CD
sustained	JJ
thornless	JJ
yarns	NNS
rhetorically	RB
Patache	NNP
MED	NNP
Financial	NNP
Skirvin	NNP
alternative	JJ
upset	JJ
nutritional	JJ
pick	VB
crisis	NN
Malaysia	NNP
threat	NN
applauded	VBN
merger	NN
tell	VB
scant	JJ
magnets	NNS
chambers	NNS
lustily	RB
refinance	VB
confirmation	NN
ELE	NNP
Black	NNP
congressman	NN
violated	VBD
use	VB
proceeds	NNS
Corporacion	NNP
allegation	NN
powered	VBN
pagers	NNS
Unions	NNS
Vice	NNP
meant	VBD
Hanger-Silas	NNP
fall	NN
formerly	RB
annual	JJ
Jae	NNP
bosses	NNS
legally	RB
Montrose	NNP
BBCO54	NNP
bull	NN
Jeep	NNP
premier	NN
hinges	VBZ
Trinidad	NNP
D.	NNP
Salt	NNP
considered	VBN
Maranhao	NNP
Poa	NNP
TVs	NNS
flawed	JJ
adviser	NN
engineer	NN
The	DT
banks	NNS
striking	JJ
tour	NN
shutter	VB
--	:
proven	VBN
spews	NNS
45-year-old	JJ
holdings	NNS
restaurants	NNS
French	JJ
partners	NNS
powder	NN
Kummer	NNP
Monica	NNP
suckers	NNS
whether	IN
clerk	NN
1985	CD
delivery	NN
separating	VBG
Onishi	NNP
Fujitsu	NNP
beet	NN
manufactured	VBN
refuse	NN
stop	NN
remove	VB
economist	NN
Hunt	NNP
biologist	NN
smelting	NN
hospital	NN
back	RB
Reservation	NNP
sedate	VB
web	NN
schedule	NN
unsafe	JJ
jellies	NNS
resumes	VBZ
Japanese	JJ
replacement	NN
physical	JJ
contest	NN
medical-imaging	JJ
Powerfin	NNP
capacity-boosting	JJ
convince	VB
Yallourn	NNP
shoots	NNS
disks	NNS
awaiting	VBG
1995	CD
top	JJ
135,000	CD
hope	NN
gravel	JJ
operate	VB
dormitories	NNS
buildup	NN
WHEN	WRB
accusations	NNS
yen	NNS
sized	VBN
rains	NNS
hole	NN
explosion	NN
weapon	NN
Taffeta	NNP
mistake	NN
industrial	JJ
Revlon	NNP
seen	VBN
likes	NN
riding	VBG
canned	VBD
Chunnel	NNP
CUBA-NUCLEAR	NNP
calling	VBG
dense	NN
Avedis	NNP
Fall	NNP
40-megawatt	JJ
connection	NN
virtually	RB
charge	NN
same	JJ
magazine	NN
Camelot	NNP
procedures	NNS
States	NNPS
concentrate	VB
tense	NN
intense	JJ
Forrest	NNP
Hyun	NNP
holiday	NN
notify	VB
Saint-Gobain	NNP
campaign	NN
faith	NN
war	NN
910	CD
water	NN
Carolina	NNP
Believers	NNS
incentives	NNS
never-opened	JJ
slightly	RB
duplicates	VBZ
centered	VBN
oil-fueled	JJ
lives	NNS
Squaw	NNP
larger	JJR
research	NN
Hall	NNP
subsidies	NNS
very	RB
be	VB
Roadmaster	NNP
ship	VB
classification	NN
mango	NN
Recently	RB
troubles	NNS
'80s	NNS
values	NNS
Calgary	NNP
Centre	NNP
risky	JJ
morning	NN
sold	VBN
cogeneration	NN
It	PRP
motors	NNS
irons	NNS
announced	VBN
Negotiations	NNS
high-techs	NNS
Feb.	NNP
seventh	JJ
body	NN
laws	NNS
key	JJ
beam	NN
15,000	CD
ways	NNS
assembles	NNS
50	CD
Completion	NN
seaweed	NN
fragrances	NNS
silicon	NN
intestinal	JJ
registration	NN
various	JJ
Adrienne	NNP
Burdette	NNP
OraVax	NNP
employs	VBZ
south-facing	NN
cases	NNS
production-line	JJ
labels	NNS
borrowing	NN
written	VBN
spills	NNS
Shoreham	NNP
aimed	VBN
oversees	VBZ
wants	VBZ
Viglen	NNP
corporate	JJ
boathouse	NN
seek	VB
reds	NNS
Mass.	NNP
Fertilizer	NNP
Md.	NNP
plaintiffs	NNS
fewer	JJR
outlay	NN
editorial	NN
harboring	VBG
articles	NNS
Transcript	NNP
follows	VBZ
heart	NN
complex	NN
persist	VB
Murdoch	NNP
cardiovascular	JJ
Guard	NNP
class	NN
Northrop	NNP
Facilities	NNP
mine	NN
unchanged	JJ
SENT	NNP
analgesics	NNS
employing	VBG
candidate	NN
reduce	VB
BE	NNP
closing	VBG
smeared	VBN
automakers	NNS
electronic	JJ
governments	NNS
allowing	VBG
telecommunications	NN
Barbra	NNP
violate	VB
Ilbo	NNP
random	JJ
Gill	NNP
sludge	NN
chip	NN
120,000	CD
BMWs	NNS
warheads	NNS
2142EST	CD
plantocracy	NN
director	NN
Burlington	NNP
Kan	NNP
51-percent	JJ
lay	VB
P.J	NNP
protected	JJ
respectively	RB
developing	VBG
Trish	NNP
S.C.	NNP
Democratic	JJ
Pleasant	NNP
fourth-generation	JJ
capital	NN
reprocessing	NN
Overall	JJ
flavor	NN
Stevenson	NNP
Tariffs	NNS
center	NN
rice	NN
lake	NN
activated	VBN
kids	NNS
anybody	NN
Sadic	NNP
not	RB
minivans	NNS
stake	NN
Maine	NNP
described	VBN
emanating	VBG
post-Cold	JJ
legal	JJ
Boxwood	NNP
5,000-acre	JJ
resources	NNS
farmer	NN
pulp	NN
Buda	NNP
Argentina	NNP
3/8	CD
Santander	JJR
whiskey	NN
Maspeth	NNP
card	NN
10-hour	JJ
Early	RB
ban	NN
print	NN
Foundation	NNP
core	NN
Henning	VBG
full-page	JJ
shipping	NN
moths	NNS
Tatum	NNP
64	CD
pick-up	NN
election	NN
Anglers	NNP
SHORE	NNP
Vt.	NNP
're	VBP
Krakow	NNP
intends	VBZ
binge	NN
Sellecks	NNS
50,000	CD
incomes	NNS
related	JJ
College	NNP
beckoned	VBN
Harold	NNP
carmakers	NNS
embarks	VBZ
Alvarez	NNP
conservatives	NNS
mid-1980s	NNS
Feb/29/96	NNP
fit	VB
weekends	NNS
replace	VB
latest	JJS
hero	NN
breathe	NN
jungle	NN
affecting	VBG
blue-collar	JJ
Correnti	NNP
reasons	NNS
Ambassador	NNP
1992-1994	CD
round	NN
saga	NN
Quinn	NNP
El	NNP
T-100	CD
Ispat	NNP
making	VBG
New	NNP
9,407	CD
thin	JJ
rain	NN
accelerating	VBG
check	VB
watched	VBD
contrast	NN
hold	VB
Allmerica	NNP
assemblyman	NN
Country	NNP
OSB	NNP
access	NN
Building	VBG
analysts	NNS
hundreds	NNS
Palmdale	NNP
themselves	PRP
rival	NN
-01-11-96	CD
Archbold	NNP
discussed	VBD
Wilcox	NNP
Zoological	NNP
Greenwich	NNP
edelweiss	NN
Merida	NNP
Requena	NNP
lenders	NNS
289,000	CD
implants	NNS
Services	NNP
Cream	NNP
cutting	VBG
2.6	CD
Nobody	NN
occur	VB
fungi	NNS
Costner	NNP
Goldman	NNP
Lurgi	NNP
Charleston	NNP
Cervone	NNP
decayed	VBN
poisonous	JJ
BET	NNP
Securities	NNP
forebear	NN
bureaucracy	NN
recirculation	NN
Sr.	NNP
4.3	CD
ruled	VBD
designated	VBN
Shares	NNS
wrong	JJ
data	NNS
Michigan	NNP
fought	VBN
organized	VBN
cancers	NNS
manufacturer	NN
snow	NN
reais	NN
statistics	NNS
devaluation	NN
Lockheed	NNP
thing	NN
centuries-old	JJ
so	RB
1,400	CD
After	IN
cancel	VB
specialist	NN
Experts	NNS
Labor	NNP
convertible	NN
poor	JJ
concluded	VBD
electric	JJ
Morristown	NNP
plotting	VBG
TT	NNP
landowner	NN
churn	VB
secretly	RB
manager	NN
commentary	NN
AS	NNP
burdens	NNS
imported	VBN
1991	CD
bank	NN
chose	VBD
try	VB
leaks	NNS
law	NN
lowest-paid	JJ
stepped	VBD
pound	NN
fishing	NN
Ulster	NNP
Robert	NNP
transfer	VB
jobs	NNS
AUSTIN	NNP
helps	VBZ
Jong	NNP
Sibley	NNP
V-8	JJ
flowing	VBG
cubic	JJ
all-round	JJ
Saudi	NNP
Cleveland	NNP
YORK	NNP
miner	NN
leaking	VBG
relating	VBG
corporations	NNS
beat	VB
attack	NN
Who	WP
features	NNS
Insiders	NNS
handful	NN
Vienna	NNP
Infrastructure	NNP
Southeast	JJ
Ecosystem	NNP
Pruett	NNP
environmental	JJ
working	VBG
rolls	NNS
ASE	NNP
animals	NNS
DEADLINE	NNP
leaning	VBG
milk	NN
Aeronautica	NNP
chipmaker	NN
sugar	NN
does	VBZ
approved	VBN
axle	NN
leaves	NNS
harder	RBR
17:31	CD
plus	CC
averaging	VBG
1,500	CD
auto	NN
Finance	NNP
tire	NN
Unnamed	JJ
Steve	NNP
Ms.	NNP
noting	VBG
team	NN
pet	NN
Citroen	JJ
Ukraine	NNP
Cartersville	NNP
anencephaly	RB
one-third	NN
firing	NN
Much	JJ
side	NN
PET	NNP
10-year-old	JJ
effects	NNS
shelter	NN
Fat	NN
peace	NN
Central	NNP
millirems	NNS
architect	NN
Mitsui	NNP
presses	NNS
Naturalists	NNS
China	NNP
continuing	VBG
financed	VBN
reforming	VBG
clinical	JJ
Is	VBZ
activities	NNS
surpassed	VBN
Bureau	NNP
shortcomings	NNS
Universal	NNP
took	VBD
Saemann	NNP
undisclosed	JJ
disappeared	VBN
coal-fired	JJ
served	VBD
tracking	NN
Lambert	NNP
Robinson	NNP
invisible	JJ
half-staff	NN
decade	NN
bet	NN
influenced	VBN
welcome	VB
5.79	CD
Wash.	NNP
16.3	CD
business	NN
failed	VBD
duplicate	VB
PVC	NN
descend	VB
Laboratory	NN
meetings	NNS
supervisor	NN
county	NN
DeMichele	NNP
fact	NN
serve	VB
Call	VB
Butler	NNP
degrees	NNS
One	CD
Hills	NNP
seedings	NNS
provisions	NNS
Elf	NN
transmit	VB
compare	VB
Lonergen	NNP
utilize	VB
opposition	NN
remain	VB
Japan	NNP
shipments	NNS
EVE	NNP
263	CD
shifted	VBN
Clean	NNP
outlined	VBD
pans	NNS
reports	NNS
concerned	VBN
refugees	NNS
openings	NNS
released	VBN
Nelson	NNP
settled	VBD
dock	NN
radiation-related	JJ
1902	CD
risked	VBD
City	NNP
submit	VB
Amoco	NNP
operator	NN
killing	VBG
quarterly	JJ
Living	VBG
Land	NNP
sense	NN
Ceara	NNP
oils	NNS
Shi	NNP
killed	VBN
assisted-suicide	JJ
Last	JJ
3.5-inch	JJ
Kao	NNP
approach	NN
boiler	NN
1.615	CD
anti-inflammatory	JJ
Initially	RB
1980s	CD
joint	JJ
paint	VB
A	DT
ROBERTS	NNP
civilian	JJ
gases	NNS
With	IN
Sanderson	NNP
Goldsboro	NNP
Sweden	NNP
acids	NNS
Tarrytown	NNP
;	:
Trustee	NNP
260	CD
catalogs	NNS
Dome	NNP
studio	NN
Chevrolet	NNP
Cemento	NNP
profits	NNS
Sonoco	NNP
indeed	RB
task	NN
bread	NN
Gorham	NNP
mileage	NN
arrival	NN
potentially	RB
Cannon	NNP
responsible	JJ
require	VB
head	NN
PowerGen	NNP
Further	JJ
green	JJ
array	NN
lakes	VBZ
significantly	RB
BMW-Austria	NNP
slated	VBN
exhaust	JJ
Executive	NNP
shifting	VBG
TI-Acer	NNP
slam	NN
outside	IN
Nigel	NNP
BJP	NNP
juices	NNS
1.8	CD
1,000	CD
Risk	NNP
Late	RB
Gephardt	NNP
Seven	CD
catering	VBG
Belgian	JJ
amid	IN
0.80	CD
dining	NN
Connie	NNP
promote	VB
lead	VB
glitches	NNS
Leeahtham	NNP
Forces	NNS
Oncolysin	NNP
juice	NN
Lynn	NNP
cellular	JJ
an	DT
Hayes	NNP
permits	NNS
Chiu	NNP
removed	VBN
CQ	NNP
facts	NNS
Buick	NNP
Officials	NNS
387	CD
Natural	NNP
Murphy	NNP
highest-paid	JJ
Tsuruga	NNP
staffing	NN
1960s	CD
finish	VB
26	CD
gas	NN
125	CD
Wilson/New	NNP
piece	NN
fleas	NNS
warm	JJ
takeover	NN
potato	NN
disappointed	VBN
purchase	NN
casual	JJ
eagerness	NN
T-Cell	NNP
completing	VBG
solar	JJ
soya	NN
grew	VBD
Kaneb	NNP
Olin	NNP
furnace	NN
front-runners	NNS
Maeil	NNP
radiation	NN
flow	NN
feed	NN
must	MD
Reading	NNP
Bulbs	NNS
breaks	NNS
behind	IN
pessimism	NN
Bronx	NNP
among	IN
1A6	NNP
third	JJ
area	NN
377.5	CD
gato	NNP
easier	JJR
church	NN
auxins	NNS
Texas-area	NNP
organizing	VBG
round-table	JJ
Talks	NNS
Q	NNP
hoax	NN
`s	JJ
Society	NNP
handling	VBG
new	JJ
marketable	JJ
MAJOR	NNP
clause	NN
sister	NN
17:33	CD
broader	JJR
Build	VB
barrel	NN
pigment	NN
That	DT
question	NN
refinery	NN
executive	NN
patrol	JJ
Malaga	NNP
lotions	NNS
wildflowers	NNS
pretax	JJ
DRAM	NNP
Her	PRP$
tin	NN
tower	NN
bankers	NNS
Sachon	NNP
Project	NNP
times	NNS
leaders	NNS
KwaZulu-Natal	JJ
evaluated	VBN
Glass	NNP
prosperity	NN
colder	JJR
Copper	NNP
certainly	RB
Daimler	NNP
destroying	VBG
chain	NN
saving	VBG
Gore	NNP
Thailand	NNP
Katz	NNP
Ryder	NNP
covers	NNS
2.4-billion	JJ
extinction	NN
exceeded	VBD
vine	NN
PRIMARY	NN
celebrated	VBD
resonate	VB
20-fold	JJ
luxury	NN
summers	NNS
CANDA	NNP
square-stem	NN
coal	NN
capable	JJ
Secaucus	NNP
Despite	IN
failures	NNS
Bogota	NNP
scaled-down	JJ
Surrey-based	JJ
Orem	NNP
million-square-foot	JJ
wafer	NN
pact	NN
toilet	NN
find	VB
percent	NN
Tarhunah	NNP
flew	VBD
2,249	CD
Samsung	NNP
Camrys	NNP
Airport	NNP
Class	NN
select	VB
FRAMINGHAM	NNP
October	NNP
Bryan	NNP
blood	NN
praised	VBD
Stover	NNP
Napocor	NNP
Aiken	NNP
forgive	VB
union	NN
purposes	NNS
reception	NN
exceedingly	RB
Areas	NNS
revalue	VB
eastern	JJ
humming	JJ
stopgap	JJ
transferring	VBG
trip	NN
Bloomberg	NNP
justify	VB
itself	PRP
boundaries	NNS
So	RB
lockout	NN
Depression-era	NNP
CIP	NNP
Potato	NNP
create	VB
faltered	VBN
nice	JJ
private-sector	JJ
feels	VBZ
1,700	CD
Etess	NNP
resentment	NN
ABN	NNP
chapters	NNS
1.2	CD
economical	JJ
upgrading	VBG
Others	NNS
specimen	NNS
500,000-square-foot	JJ
medical	JJ
inflation	NN
TI	NNP
Kagga	NNP
noses	NNS
cultivate	VB
iced-over	NN
diner	NN
6,000	CD
Time	NNP
chief	JJ
fueled	VBN
Tenn	NNP
fund	NN
acid	NN
Siasconset	NNP
freeze	VB
absolutely	RB
branch	NN
Doyle	NNP
semiconductor	NN
Louisiana	NNP
Clausen-Koch	NNP
populated	JJ
faster	RBR
C$	$
Catholic	NNP
hard	JJ
30	CD
hostile	JJ
drugmaker	NN
Champlain	NNP
Boehme	NNP
declined	VBD
reopen	VB
distribution	NN
dismal	JJ
resin-manufacturing	JJ
relationships	NNS
Dynamics	NNPS
commodity	NN
Tech	NNP
Amid	IN
bulbs	NNS
trader	NN
mystical	JJ
francs	NNS
An	DT
Montero	NNP
Bobby	NNP
cooperative	NN
JDC	NNP
revoking	VBG
security	NN
dollars	NNS
coastal	JJ
vision	NN
scooter	NN
bolts	NNS
four	CD
northeastern	JJ
resulting	VBG
disappearing	NN
Darwin	NNP
Peruvians	NNPS
border	NN
rivets	VBZ
Richard	NNP
closes	VBZ
wedding	VBG
soft-drink	NN
Canadian	JJ
victory	NN
ounces	NNS
48-inch	JJ
pressurized	JJ
eight-inch-diameter	JJ
MATERIAL	NNP
comments	NNS
loves	VBZ
Morgenstern	NNP
underutilized	VBN
Milford	NNP
since	IN
blooms	NNS
detergent	NN
constant	JJ
5,100	CD
earning	VBG
recognized	VBD
Molinari	NNP
powerful	JJ
120	CD
bunch	NN
tide	NN
Guymon	NNP
assistant	NN
Holderbank	NNP
pie	NN
advantage	NN
Ontario	NNP
Suzuka	NNP
Detroit-based	JJ
share	NN
exorbitant	JJ
14-year-old	JJ
author	NN
Rio	NNP
wagons	NNS
three-inch	JJ
vegetables	NNS
California-based	JJ
development	NN
STORY	NN
1988	CD
indicates	VBZ
18th-century	JJ
cement	NN
fell	VBD
Tokyo	NNP
mountains	NNS
third-quarter	JJ
burning	NN
Utilities	NNPS
contain	VB
recounted	VBD
million-deutsche	JJ
tents	NNS
sued	VBD
Colibri	NNP
event	NN
honest	JJ
erstwhile	JJ
butchers	NNS
Mercedes	NNP
insures	VBZ
credits	VBZ
prior	RB
relocations	NNS
Arauco	NNP
coats	NNS
Bonamil	NNP
Cypress	NNP
``	``
Jersey-based	JJ
Without	IN
sinensis	JJ
sexually	RB
perhaps	RB
watering	VBG
Dawn	NNP
Tuzla	NNP
budget	NN
END	NNP
results	NNS
Fujimori	NNP
groundless	JJ
improvement	NN
student	NN
Hundreds	NNS
accuses	VBZ
smoke	NN
400,000	CD
buns	NNS
slight	JJ
levied	VBN
different	JJ
Cordoba	NNP
Olympics	NNPS
Vannelle	NNP
fruits	NNS
Chippewa	NNP
affects	VBZ
alert	JJ
deposition	NN
Korean	JJ
Caprice	NNP
management-inspired	JJ
da	NNP
career	NN
between	IN
money	NN
robust	JJ
size	NN
sewn	JJ
Leonard	NNP
Welcome	NNP
numbers	NNS
aerial	JJ
selecting	VBG
Helmig	NNP
flash	NN
airplane	NN
associated	VBN
exporting	VBG
coast	NN
bottling	VBG
News	NNP
had	VBD
As	IN
Trans	NNP
Exploration	NNP
Dow	NNP
STK	NNP
16.5	CD
spiritual	JJ
Hummingbirds	NNP
Speaking	NN
Wells	NNP
wrestling	NN
cleared	VBN
family	NN
satellite	NN
conformity	NN
meanwhile	RB
reevaluating	VBG
800-829-5116	CD
final	JJ
Robles	NNP
Voorhees	NNP
diseases	NNS
joints	NNS
To	TO
letter-writing	JJ
weather	NN
Bill	NNP
Newnan	NNP
memo	NN
steep	JJ
average	JJ
processors	NNS
icon	NN
Perseverance	NNP
16	CD
misdemeanor	NN
first-of-a-kind	JJ
rejected	VBN
those	DT
administrative	JJ
foundered	VBN
fabric	NN
choose	VB
erasing	VBG
impresses	VBZ
risks	NNS
slave	NN
Hindustan	NNP
hoped	VBD
almost	RB
car	NN
Kevin	NNP
pose	VBP
Hong	NNP
Caravans	NNPS
Dublin	NNP
damn	RB
puts	VBZ
Giusti	NNP
ouster	NN
emerges	VBZ
years	NNS
Nancy	NNP
roar	NN
low-cost	JJ
Northridge	NNP
breathing	NN
13	CD
blocked	VBD
breakneck	JJ
flat-roll	NN
explained	VBD
18.9	CD
198	CD
residence	NN
neighborhood	NN
point	NN
MDS	NNP
Chatham	NNP
co-founder	NNP
measuring	VBG
hours	NNS
Chase	NNP
past	JJ
ranger	NN
professional	JJ
Earlier	RBR
considering	VBG
Bosnian	JJ
remainder	NN
established	VBN
screeching	VBG
free	JJ
whips	NNS
Beach	NNP
saw	VBD
deck	NN
Keynes	NNP
machinery	NN
slumped	VBD
equally	RB
Steyr	NN
Makin	NNP
technical	JJ
telephone	NN
himself	PRP
30-40	JJ
locate	VB
evidence	NN
towards	VBZ
Wagon	NNP
packages	NNS
lunch	NN
Rockwell	NNP
operating	VBG
Bowlin	NNP
Mason	NNP
sugars	NNS
Iva	NNP
placement	NN
calcium	NN
switch	NN
Chris	NNP
ADD	NNP
Oil	NNP
pant	NN
records	NNS
acres	NNS
Milgroom	NNP
modernize	VB
lost	VBD
north	NN
semiconductors	NNS
Silhouette	NNP
repertory	NN
scours	VBZ
slowing	VBG
tried	VBD
Marlborough	NNP
Coates	NNP
Reed	NNP
cedar	NNP
manufactures	VBZ
FOLLOWS	NNP
Rankin	NNP
do	VB
margins	NNS
Zwetsche	NNP
from	IN
tariff	NN
Ocotillo	NNP
moisten	VB
Mack	NNP
capability	NN
evolved	VBN
devastation	NN
cried	VBN
poses	VBZ
unemployment	NN
newsletters	NNS
Logic	NNP
Pacific	NNP
for	IN
Almost	RB
1,450-megawatt	JJ
away	RB
water-treatment	NN
Singer	NNP
Batangas	NNP
raw	JJ
cracks	NNS
Gap	NNP
landfills	NNS
agencies	NNS
Pearson	NNP
2,450	CD
consolidate	VB
408	CD
home	NN
scrap	NN
tentative	JJ
expensive	JJ
Cruiser	NNP
families	NNS
Wray	NNP
Mannheim	NNP
biological	JJ
presided	VBD
Phillips	NNP
base	NN
affected	JJ
Janesville	NNP
all-male	JJ
Hudson	NNP
Accord	NNP
worth	IN
cavern	NN
WORKERS	NNS
Physostegia	NNP
message	NN
limits	NNS
full-size	JJ
main	JJ
one-fifth	JJ
dome	NN
allege	VBP
dismantle	VB
instead	RB
breaches	NNS
EG&G	NNP
sediment	NN
Intelligence	NNP
sentence	NN
60-year-	JJ
polyester	NN
41	CD
balloonist	NN
Engines	NNP
Bosnia	NNP
Madras	NNP
gypsum	NN
announce	VB
harmful	JJ
Auto	NNP
paintings	NNS
nowhere	RB
onto	IN
endorsement	NN
firms	NNS
generation	NN
suitable	JJ
signs	NNS
ate	VBP
were	VBD
customers	NNS
Monday	NNP
textile	NN
Tarde	NNP
7.25-an-hour	CD
commentator	NN
desk	NN
Sabourin	NNP
patio	NN
properties	NNS
loomed	VBN
treating	VBG
packs	VBZ
Systems	NNP
sauce	NN
questionable	JJ
upholstery	NN
refrigerator	NN
extensively	RB
Camaros	NNS
habits	NNS
net	JJ
existing	VBG
Zildjian	NNP
SCR	NNP
habitat	NN
Having	VBG
spread	NN
150-pound	JJ
resign	VB
butterflies	NNS
two	CD
toiling	VBG
sorts	NNS
difference	NN
Their	PRP$
NI	NNP
premiums	NNS
rage	NN
units	NNS
74	CD
Full	NNP
significance	NN
additional	JJ
B	NNP
ALBANY	NNP
Weymouth	NNP
4.1	CD
pollution-monitoring	JJ
Cadiz	NNP
joined	VBD
Phil	NNP
August	NNP
specifically	RB
offers	VBZ
vast	JJ
tidbits	NNS
plants	NNS
plumbing	NN
uranium	NN
late	JJ
sap	VB
Chargeurs	NNP
housed	VBD
Peak	NNP
Water	NNP
Jobs	NNPS
countryside	NN
nationwide	JJ
threaten	VB
embargo	NN
Ten	CD
Macon	NNP
Connecticut	NNP
Joffre	NNP
attend	VB
3.55	CD
EIS	NNP
document	NN
Ontario-based	JJ
arduous	JJ
Bridgwater	NNP
obedient	JJ
capitalize	VB
gyros	NNS
longer	RB
hundred	CD
150,000	CD
RWE	NNP
trust	VB
Outpacing	VBG
taught	VBN
dingy	JJ
flatbed	JJ
Costs	NNS
period	NN
proposals	NNS
84	CD
buying	VBG
garden	NN
retreat	VB
Chihuahua	NNP
Dini	NNS
Bothell	NNP
flowers	NNS
early	JJ
110	CD
Only	RB
NYT	NNP
transition	NN
sons	NNS
methods	NNS
champion	NN
Chernobyl	NNP
boisterous	JJ
W.	NNP
III	NNP
Baxter	NNP
Manassas	NNP
tears	NNS
Authority	NNP
understand	VB
experiment	NN
Utley	NNP
Orleans-based	JJ
referring	VBG
plead	VB
value	NN
Air	NNP
preaching	VBG
furniture	NN
citations	NNS
underlined	VBD
surfaced	VBD
reliable	JJ
600,000-square-foot	JJ
Bristol-Myers	NNP
managment	NN
Fernando	NNP
fraud	NN
GRENADA	NNP
addresses	VBZ
Carlito	NNP
hostage	NN
field	NN
NAFTA	NNP
ends	VBZ
pathologist	NN
credited	VBN
Yugoslavia	NNP
Troy	NNP
reputed	VBN
reporting	VBG
Machines	NNPS
Rapids	NNP
intervenes	NNS
astonishing	JJ
wish	NN
facilities	NNS
Lignite	NNP
doing	VBG
nitrogen	NN
entomology	NN
2204EST	CD
Luo	NNP
shakeups	NNS
31.3	CD
motivation	NN
Nissan	NNP
image	NN
earnings	NNS
lawsuit	NN
bright	JJ
argument	NN
tanks	NNS
Claycomo	NNP
line	NN
charged	VBN
efficiently	RB
1997	CD
Norris	NNP
camellia	NN
Craft	NN
Adjacent	JJ
posted	VBD
fourth-story	JJ
Kalgoorlie	NNP
plane	NN
shot	NN
answers	VBZ
grower	NN
aside	RB
25	CD
Super	NNP
Alpha	NNP
wrote	VBD
up	RP
Shenzhen	NNP
NABE	NNP
America	NNP
multinational	JJ
Van	NNP
totaling	VBG
This	DT
.	.
investigator	NN
AIR	NNP
ownership	NN
lax	NN
exposure	NN
Ga.	NNP
kilowatts	NNS
excess	JJ
intended	VBN
Daewoo	NNP
merged	JJ
the	DT
primarily	RB
shipyards	NNS
might	MD
Charlotte	NNP
accounting	NN
cultivating	VBG
regarding	VBG
1	CD
94	CD
GmbH	NNP
Street	NNP
dates	NNS
distinctive	JJ
inviting	VBG
sort	NN
answer	NN
Dasa	NNP
Stocks	NNS
plastics	NNS
rand	NN
6	CD
came	VBD
Indians	NNPS
reveals	VBZ
At	IN
brown-coal-fired	JJ
abundant	JJ
Raytheon	NNP
critic	NN
Science-based	JJ
peek	VB
example	NN
Yankee	NNP
decontamination	NN
Association	NNP
gloom	NN
Mine	NNP
increases	NNS
favor	NN
seeds	NNS
Todd	NNP
Toyota	NNP
Aviation	NNP
lunacy	NN
sluggish	JJ
mid-February	JJ
pouring	VBG
killer	NN
recipe	NN
combines	VBZ
Millbrook	NNP
Quincy	NNP
savvy	NN
investors	NNS
workforce	NN
8.7	CD
pipe	NN
benefit	VB
open	VB
drumsticks	NNS
association	NN
liable	JJ
Dakota	NNP
informal	JJ
finished	VBN
date	NN
previously	RB
22.3	CD
Furniture	NNP
Westborough	NNP
Sara	NNP
tractor	NN
destruction	NN
mines	NNS
two-day	JJ
Thus	RB
Sparks	NNP
Bataan	NNP
Journal	NNP
instances	NNS
nationalist	NN
Matthey	NNP
levying	VBG
origin	NN
Mordechai	NNP
soundly	RB
plaster-board	NN
concern	NN
Manchester	NNP
Tseng	NNP
ivy	NN
appliances	NNS
WORTH	NNP
hitting	VBG
overtime	RB
doctor	NN
88	CD
18,500	CD
started	VBD
texture	NN
APS	NNP
differed	VBD
backside	NN
wo	MD
Chechen	NNP
40	CD
JURAGUA	NNP
thriving	VBG
microchip	NN
fanfare	NN
Electricite	NNP
La	NNP
hollowed-out	JJ
cat	NN
bombs	NNS
books	NNS
1450	CD
Not	RB
Pasteur	NNP
480,000	CD
gangs	NNS
Fears	NNS
launch	VB
plates	NNS
Sevillana	NNP
11-year	JJ
autarchic	JJ
assume	VB
award	NN
bearded	JJ
other	JJ
well-positioned	JJ
completed	VBN
Franklin	NNP
Solarex	NNP
restrain	VB
fear	NN
Christian	NNP
3-4	NN
general	JJ
Belfast	NNP
nursery	NN
involved	VBN
shows	VBZ
9.2	CD
asserted	VBD
Cienfuegos	NNS
desire	NN
liability	NN
absorbed	VBN
postpone	VB
Lutein	NNP
finest	JJS
battle	NN
governor	NN
memory	NN
Under	IN
Arbitration	NN
distributors	NNS
touched	VBN
valve	NN
SA	NNP
complained	VBD
happened	VBD
management	NN
Atlantic	NNP
joint-venture	JJ
tipped	VBN
hostages	NNS
landmark	NN
aftermath	NN
southwestern	JJ
formal	JJ
million	CD
number	NN
Huntington	NNP
Tenn.	NNP
Oklahoma	NNP
simply	RB
Medellin	NNP
ground-breaking	JJ
countries	NNS
modernizing	JJ
life	NN
foreign-policy	NN
320	CD
technician	NN
Resort	NNP
Resources	NNP
verifies	NNS
Low	NNP
private	JJ
painstakingly	RB
Joyce	NNP
Jane	NNP
cities	NNS
cancellation	NN
networks	NNS
depend	VB
your	PRP$
overseas	RB
5,000	CD
importer	NN
everything	NN
returned	VBD
Chief	NNP
right	NN
Officer	NNP
negative	JJ
hourly	JJ
supervision	NN
355	CD
need	NN
pack	NN
revitalization	NN
upstairs	NNS
Bacnotan	NNP
yet	RB
liquifies	VBZ
Corby	NNP
Friday	NNP
Big	NNP
Hartford	NNP
miss	VB
Three	CD
500-millirem	JJ
Mountain	NNP
ON	NNP
Michoacan	NNP
Dora	NNP
best	JJS
laborers	NNS
subscribe	VB
RUSSIA	NNP
investigation	NN
loyalty	NN
fetid	JJ
16-megabit	JJ
Bread	NNP
Weston	NNP
engineering	NN
ImmunoGen	NNP
practices	NNS
terms	NNS
polypropylene	NN
there	EX
sharp	JJ
Carvell	NNP
produce	VB
UCB	NNP
terephthalate	NN
15.16	CD
gratifying	JJ
Boeing	NNP
Riverhead	NNP
biggest	JJS
planning	VBG
AB	NNP
Ford-Madza	NNP
Eveready	NNP
Simon	NNP
launched	VBN
effectiveness	NN
Okeechobee	NNP
Waluj	NNP
mumbled	VBD
Richmans	NNP
pandanus	NN
Austrian	JJ
fees	NNS
MWRA	NNP
counterparts	NNS
51	CD
citing	VBG
Church	NNP
Worth-area	NNP
cross	NN
Afan	NNP
die-casting	NN
Skogindustrier	NNP
Pyongyang	NNP
Jim	NNP
Shirou	NNP
now-defunct	JJ
about	IN
B.A.T	NNP
enforce	VB
Maytag	NNP
Placid	NNP
comparable	JJ
redress	NN
Debray	NNP
marshes	NNS
calls	VBZ
strides	NNS
one-time	JJ
1984	CD
sixth	JJ
Cities/ABC	NNP
billboard	JJ
attempts	NNS
3/4	CD
prepare	VB
analyzed	VBN
inside	IN
Holding	NNP
pits	NNS
transferred	VBN
Matrix	NNP
highly-rated	JJ
Seeks	NNPS
citrus	NNP
regional	JJ
Kentucky	NNP
warms	VBZ
age	NN
Babcock	NNP
species	NNS
Bay	NNP
trucker	NN
rods	NNS
wide	JJ
Sea	NNP
middle	NN
Norkse	NNP
180,000	CD
consider	VB
1.3	CD
1936	CD
advisory	NN
prosper	VB
kill	VB
ivory	NN
brouhaha	NN
SHARLOW	NNP
bellhop	NN
pumped	VBN
Depot	NN
died	VBD
poll	NN
sugar-growing	JJ
CANDIDATES	NNP
weak	JJ
names	NNS
835	CD
called	VBN
hectoliters	NNS
campaigned	VBN
resume	VB
overtaxing	VBG
colors	NNS
renew	VB
Libyan	NNP
Kong	NNP
missiles	NNS
Unicom	NNP
bidders	NNS
Nuclear	NNP
trusted	VBD
Zacapu	NNP
multi-billion	JJ
Michel	NNP
upstate	NN
kills	VBZ
clear	JJ
during	IN
Zurich	NNP
take	VB
Crude	NN
larvae	NN
overassessments	NNS
trained	JJ
mopped	VBN
Seoul	NNP
code	NN
unelectable	JJ
global	JJ
Phillip	NNP
Sunnyvale	NNP
auto-making	NN
Although	IN
Russian	JJ
particularly	RB
compound	NN
Construction	NN
deboning	VBG
mini-vans	NNS
remaining	VBG
assembly	NN
inter-Korean	JJ
testimony	NN
Rifkin	NNP
189	CD
Uswachoke	NNP
Administration	NNP
focus	VB
Noyes	NNP
stock	NN
partly	RB
count	VB
Wyeth-Ayerst	NNP
Mo.	NNP
prospect	NN
F-MX	NN
Mich.	NNP
refining	NN
permanently	RB
poster	NN
130,000-a-year	JJ
dismantled	VBN
boundary	NN
Loral	NNP
revamped	VBD
biologists	NNS
Cohen	NNP
evaluating	VBG
holes	NNS
royal	NN
Domino	NNP
device	NN
CVG	NNP
three	CD
Montgomery	NNP
words	NNS
mature	JJ
Bauang	NNP
supplements	NNS
Chile	NNP
LOD	NNP
LAB-REBORN	NNP
opened	VBD
Hood	NNP
700	CD
parent	NN
Plc	NNP
Nickel	NNP
nations	NNS
unloading	VBG
33	CD
investigations	NNS
climate	NN
emerging	VBG
Tel	NNP
Crime	NN
seafood	NN
1970s	NNS
consolidated	VBN
meshes	VBZ
Varga	NNP
Unit	NNP
MOSS	NNP
bloom	VB
weight	NN
Point	NNP
laid	VBN
roofing	NN
glaciers	NNS
winners	NNS
regards	VBZ
lots	NNS
bottle	NN
Claire	NNP
195.5	CD
Seattle	NNP
Magic	NNP
133	CD
manufacturing	NN
430,000-square-foot	JJ
co-chief	JJ
prompting	VBG
welding	VBG
Sharlow	NNP
Jornal	NNP
mounting	VBG
austerity	NN
REMAINS	NNP
discovered	VBD
disc	NN
rod	NN
Cold	NNP
solo	NN
Hanford	NNP
Forget	VB
retired	JJ
exceeds	VBZ
nutrients	NNS
leisurely	JJ
Hsinchu	NNP
Minnesota	NNP
370	CD
Williamsburg	NNP
outdated	VBN
terrorists	NNS
buyer	NN
Ankeny	NNP
Space	NNP
knowledge	NN
Naturally	RB
moneduloides	NNS
greater	JJR
cameraman	NN
cut-and-sew	JJ
Wednesday	NNP
include	VBP
known	VBN
lawsuits	NNS
tiny	JJ
convenience	NN
Bell	NNP
capacity	NN
Gonzales	NNPS
:55	CD
19.81	CD
1A	NNP
54-inch	JJ
8.25	CD
traditionally	RB
Tony	NNP
unrelated	JJ
solvents	NNS
Pequiven	NNP
Garelick	NNP
say	VBP
artillery	NN
upgrades	NNS
swimming	NN
Vanunu	NNP
bites	VBZ
FDA	NNP
Stroehmann	NNP
Taysan	NNP
souped-up	JJ
Hartman	NNP
640	CD
meats	NNS
F-16	CD
recent	JJ
210	CD
agrees	VBZ
competitions	NNS
districts	NNS
owe	VB
deterred	VBN
H3Inc	NNP
toured	VBD
Agent	NNP
quality	NN
-LSB-	,
sabotaged	VBN
Hosmalin	NNP
81.7	CD
throughput	NN
5/8	CD
1996	CD
Fortune	NNP
pence	NN
lawyers	NNS
moist	JJ
on-line	JJ
pass	VB
Cod	NNP
ran	VBD
Greek	NNP
fibers	NNS
:45	,
LILCO	NNP
wary	JJ
underscored	VBD
hub	NN
Germany	NNP
reported	VBD
quick	JJ
42-year-old	JJ
Arbeiter	NNP
SCATTERED	VBD
viability	NN
Loro	NNP
seriously	RB
repairing	VBG
fungus	NNP
secrets	NNS
Midwestern	JJ
investigate	VB
1990	CD
medicines	VBZ
Emirates	NNS
shutdown	NN
former	JJ
Austria	NNP
poison	NN
motorcycle	NN
majority	NN
Germann	NNP
planted	VBN
idle	JJ
drive	NN
independent	JJ
criminal	JJ
scattered	VBN
biomass	NN
principles	NNS
Opponents	NNS
well-behaved	JJ
efforts	NNS
chemical-weapons	NNS
Paper	NNP
prison	NN
8.50-an-hour	CD
ECO	NNP
specks	NNS
400-member	JJ
Recycling	NNP
significant	JJ
18,035	CD
marijuana	NN
3,000	CD
installing	VBG
Lever	NNP
Idaho	NNP
January	NNP
F-22	NN
swing	NN
repayment	NN
UAW	NNP
Earth	NNP
Cuban	JJ
ball	NN
Newmont	NNP
runway	NN
laminates	NNS
retraining	NN
pump	VB
4,000	CD
Price	NNP
France	NNP
roller	NN
racism	NN
volume	NN
unprecedented	JJ
as	IN
476	CD
Comanche	NNP
Linotype	JJ
burnings	NNS
Motorola	NNP
190.1p	CD
alongside	IN
Miss.	NNP
lakeshore	NN
juxtaposition	NN
standing	NN
present	VBP
quoted	VBN
sprawling	VBG
Duisburg	NNP
dairy	NN
secrecy	NN
system	NN
ironworks	JJ
passage	NN
'''	CC
Region	NNP
network	NN
Nalco	NNP
agave	JJ
equipments	VBZ
undergone	VBN
agreed	VBD
battling	NN
seedlings	NNS
Nogales	NNP
lease	NN
pull	VB
ladies	NNS
listing	VBG
Oregon	NNP
cap	VB
Pacoima	NN
curbed	VBD
Boat	NNP
Remove	NNP
negligible	JJ
Sebring	VBG
Philadephia	NNP
things	NNS
dangerous	JJ
gone	VBN
vivid	JJ
Kenneth	NNP
Skoda	NNP
Chiyoda	NNP
Challenger	NNP
knew	VBD
antiviral	JJ
spent	VBN
3.3	CD
SEC	NNP
melds	VBZ
Cedartown	NNP
absorbing	VBG
J.C.	NNP
implying	VBG
Lancaster	NNP
consulting	NN
isolated	JJ
Hapeville	NNP
sufferd	VBD
reminiscent	NN
Companies	NNS
heard	VBD
remarks	NNS
instructions	NNS
fertilizer	NN
dying	VBG
tube	NN
Yokut	NNP
Candeleria	NNP
beermaker	NN
regions	NNS
plastic	JJ
thick	JJ
Phoenix	NNP
seaports	NNS
led	VBN
Cake	NNP
hosts	VBZ
Cherokees	NNPS
environment	NN
C-17s	NNP
bend	VB
Gov.	NNP
Republican-backed	JJ
10th	JJ
work	NN
Dole	NNP
citric	JJ
Post-Transcript	NN
waters	NNS
district	NN
Squibb	NNP
laid-off	JJ
credibility	NN
criticizing	VBG
barely	RB
pre-trial	JJ
tryout	NN
procedural	JJ
drinks	NNS
proof	NN
overalls	NNS
clutch	NN
Delorean	JJ
Ohio	NNP
dubious	JJ
wWlater	RBR
Dodge	NNP
,	,
confident	JJ
southeast	NN
who	WP
contained	VBD
Imperial	NNP
reconstruction	NN
Loan	NN
went	VBD
Toyota/Lexus	NNP
streets	NNS
Hyannis	NNP
direct	JJ
Greenpoint	NNP
Feb/27/96	NNP
Though	IN
Lacers	NNS
Seacem	NNP
young	JJ
adding	VBG
automobile	NN
cannot	VBP
measured	VBN
furnishings	NNS
Fleetwood	NNP
Coca-Cola	NNP
lemon	NN
Boulevard	NNP
0.6	CD
NUYS	NNP
firings	NNS
Eau	NNP
Dud	NNP
four-month	JJ
175,000	CD
indicted	VBN
decelerate	VB
Regan	NNP
diesel	NN
6.60	CD
tens	NNS
infant	NN
2,050	CD
well-paid	JJ
Colorado	NNP
1967	CD
There	EX
selection	NN
picks	VBZ
Monetary	NNP
Of	IN
Ferdinand	NNP
Okla	NNP
Two	CD
probation	NN
three-day	JJ
every	DT
sift	VB
given	VBN
immunity-boosting	JJ
Nolan	NNP
Enron	NNP
portion	NN
Miret	NNP
allegations	NNS
Canada	NNP
possible	JJ
Sulphur	NNP
pervades	VBZ
opponents	NNS
examples	NNS
Bergamot	NNP
held	VBD
cheap	JJ
spirits	NNS
support	NN
ingredients	NNS
directed	VBD
grownups	VBZ
Futures	NNPS
doors	NNS
growing	VBG
temperatures	NNS
Sony	NNP
Pa	NNP
Orange	NNP
sometimes	RB
1957	CD
followed	VBD
Manila	NNP
component	NN
loans	NNS
Craven	NNP
fields	NNS
spectrum	NN
losing	VBG
prepares	VBZ
photovoltaic	JJ
backdrop	NN
licensing	NN
1992	CD
Granada	NNP
terminated	VBD
factory	NN
heir	NN
straight	JJ
Analysts	NNS
Collahuasi	NNP
spires	NNS
munitions	NNS
lure	VB
ANDOVER	NNP
renovation	NN
Electron	NNP
eight-	JJ
love	VBP
cold	JJ
ministers	NNS
Boise	NNP
Redmond	NNP
store-bought	JJ
communication	NN
substances	NNS
tax-refund	NN
Iomega	NNP
scrapped	VBN
February	NNP
whose	WP$
voters	NNS
study	NN
short	JJ
fighting	VBG
Boston	NNP
Besides	IN
Singapore	NNP
Estate	NNP
like	IN
come	VB
Dimona	NNP
to	TO
refined	JJ
southern	JJ
statewide	RB
115	CD
Boom	NNP
thrill	NN
seals	NNS
Africa	NNP
Lower	JJR
Pier	NNP
P.	NNP
Pendleton	NNP
behalf	NN
Brainpower	NNP
entrepreneurs	NNS
deal	NN
Tennessee-based	JJ
180,000-square-foot	JJ
polymers	NNS
anti-Japanese	JJ
account	NN
break	NN
students	NNS
yard-high	JJ
whistles	NNS
strangely	RB
despite	IN
Honda	NNP
shrinkage	NN
compressors	NNS
softsided	JJ
ruptures	NNS
products	NNS
earliest	JJS
collections	NNS
river	NN
Northvale	NNP
memorial	JJ
Spake	NNP
Island	NNP
prototype	NN
downtown	NN
service	NN
jeans	NNS
Photo	NNP
transaction	NN
Aviv	NNP
inspectors	NNS
Mineral	NNP
monthly	JJ
Wong	NNP
grits	NNS
Word	NNP
flooded	VBN
dug	NN
applaud	NN
wavelength	NN
decades-long	JJ
symbol	NN
Cone	NNP
grow	VB
BASF	NNP
highways	NNS
insulation	NN
Federal-Mogul	NNP
barber	NN
regulators	NNS
cracker	NN
subjects	NNS
abscission	NN
acknowledge	VBP
Among	IN
possibilities	NNS
cooperation	NN
spite	NN
These	DT
fifth	JJ
awestruck	RB
most-popular	JJ
damage	NN
actively	RB
V-22	NN
tear	VB
barrel-a-day	JJ
checks	VBZ
otherwise	RB
Arizona	NNP
assured	VBD
Tobago	NNP
3,300	CD
reduces	VBZ
Waste	NNP
9	CD
Merrimack	NNP
reclamation	NN
Imbhassay	NNP
Royal	NNP
contrasted	VBD
0.9	CD
Groton	NNP
caused	VBN
acquisitions	NNS
someone	NN
York	NNP
laptop	NN
advertising	VBG
establishing	VBG
6,200	CD
profound	JJ
thoroughly	RB
hulking	VBG
improperly	RB
Haad	NNP
reinforced	JJ
reorganize	VB
dismiss	VB
Venezolana	NNP
unprofitable	JJ
running	VBG
fourth	JJ
0.1	CD
release	NN
Philippine	JJ
employ	VB
bonsai	NN
postponed	VBD
walkout	NN
these	DT
''	''
Hemaraj	NNP
20.9	CD
debt	NN
And	CC
flat	JJ
Toluca	NNP
Then	RB
Mexicana	NNP
attributed	VBD
builds	VBZ
imports	VBZ
236	CD
Greer	NNP
bombing	VBG
Associated	NNP
moat	NN
news	NN
Ropers	NNS
throw	VB
somewhere	RB
conducted	VBN
withdrawing	VBG
Lowell	NNP
property	NN
faced	VBD
Pharmaceuticals	NNP
streamlining	VBG
Meanwhile	RB
contracts	NNS
detailed	JJ
revolutionize	VB
banter	NN
request	NN
raises	VBZ
protest	NN
haphazard	NN
Houston-based	JJ
2-foot	JJ
Virgin/Bechtel	NNP
spice	NN
leather	NN
rails	VBZ
rather	RB
walk	NN
contract	NN
graphite	NN
powerless	JJ
rock	NN
extension	NN
simple	JJ
implant	NN
Midnite	NNP
crow	NN
Stop	NNP
Itaipu	NNP
tombstone	NN
huge	JJ
incoming	JJ
surveyed	VBN
Sao	NNP
217	CD
bunting	NN
CIA	NNP
detect	VB
bite	VB
star	NN
63,975	CD
beyond	IN
Smith	NNP
Banco	NNP
importing	VBG
Cumberland	NNP
once-troubled	JJ
yeast	NN
Barnard	NNP
German-owned	JJ
Electric	NNP
Craigie	NNP
wildflower	NN
Merriam	NNP
imagine	VB
pot	NN
KCP&L	NNP
Juragua	NNP
borders	NNS
recruited	VBN
Eletricas	NNPS
Shrewsbury	NNP
downsized	VBN
collages	NNS
concerns	NNS
remedies	NNS
bids	VBZ
Eletrobras	NNP
workshops	NNS
Conservative	JJ
Equipment	NNP
own	JJ
distributed	VBN
soggy	JJ
litigation	NN
comes	VBZ
steel	NN
when	WRB
re-evaluating	VBG
Krulwich/New	NNP
Harvard	NNP
shirt	NN
AUT	NNP
ought	MD
carried	VBD
Forbes	NNS
1999	CD
assembly-line	JJ
desirable	JJ
equipment	NN
Mahindra	NNP
broadening	VBG
bundles	NNS
installation	NN
Santiago	NNP
sympathetic	JJ
snipers	NNS
comfortable	JJ
jumped	VBD
actuality	NN
Creek	NNP
received	VBD
hot	JJ
cheaper	JJR
means	VBZ
Hernandez	NNP
loan	NN
1973	CD
dad	NN
Moa	NNP
Iquique	NNP
child	NN
trustee	NN
offered	VBD
activity	NN
soap	NN
blamed	VBD
Pepsi	NNP
possibility	NN
leaching	VBG
fines	NNS
raised	VBD
gun	NN
Maryland	NNP
wanted	VBD
Creamery	NNP
disease	NN
crashed	VBD
chosen	VBN
charges	NNS
December	NNP
conduct	NN
apparent	JJ
demanded	VBN
resin	NN
Unipol	NNP
payments	NNS
pursue	VB
Vatterott	NNP
temporarily	RB
South	NNP
Capacity	NN
special	JJ
Sonora	NNP
buried	VBN
accomplish	VB
such	JJ
coloration	NN
enjoy	VBP
860	CD
deeper	JJR
Nihon	NNP
molding	NN
rumored	VBN
postponing	VBG
illnesses	NNS
Tuscaloosa	NNP
221	CD
Pakistan	NNP
145	CD
pondering	VBG
Hook	NNP
70,000	CD
indoors	NNS
Ruari	NNP
Fuel-Tech	NNP
Diego	NNP
Microsoft	NNP
economic	JJ
Karen	NNP
sufficient	JJ
threatening	VBG
Highway	NNP
Thai	NNP
Brock	NNP
community	NN
Madrid	NNP
bln	NN
Thomas	NNP
filled	VBN
routinely	RB
Angeles	NNP
rooftops	NNS
1/8	CD
toxic	JJ
supplied	VBN
proceeding	VBG
others	NNS
spurring	VBG
succumb	VB
Chevy	NNP
80-percent	JJ
Manuel	NNP
mark	NN
California	NNP
Greenfield	NNP
slide	NN
fruit-packing	JJ
guard	VBP
insure	VB
Bruck	NNP
ask	VB
dismissed	VBN
thinking	NN
attention	NN
chrysanthemum	NN
Grupo	NNP
Chatsworth	NNP
Republicans	NNPS
MDEST	NNP
GREER	NNP
technically	RB
tank	NN
5.6	CD
Agri-Mark	NNP
Proclaiming	VBG
summer	NN
ancillary	JJ
Cavalieri	NNP
fence-row	NN
destroyed	VBN
filing	VBG
ethylene	NN
Acty	NNP
Asia-Pacific	NNP
eventually	RB
drop	NN
contemplating	VBG
Storm	NNP
non-racial	JJ
eviscerating	VBG
Tennessee	NNP
trying	VBG
prosecuting	VBG
Abilene	NN
accuracy	NN
Kingsport	NNP
down	RP
incredible	JJ
sanctum	NN
planes	NNS
Turnpike	NNP
beds	NNS
weeks	NNS
7	CD
allows	VBZ
progress	NN
Admiral	NNP
degree	NN
Technologies	NNP
Later	RB
baht	NN
beach	NN
Sumitomo	NNP
leaf	NN
picked	VBN
Every	DT
12,000	CD
Jackson	NNP
hassle	NN
Oldsmobile	NNP
Levi	NNP
double	VB
Millstone	NNP
Packaging	NNP
On	IN
Jan/10/96	NNP
much-needed	JJ
democracy	NN
including	VBG
solubles	NNS
Fairway	NNP
rich	JJ
being	VBG
exhibit	NN
Paulsen	NNP
Digital	NNP
adults	NNS
reversed	VBD
Frigos	NNP
sorbet	VB
Vitoria	NNP
strict	JJ
one-on-one	JJ
while	IN
electronics	NNS
rainy	JJ
Norwood	NNP
deductions	NNS
spiced	VBN
45	CD
limit	NN
Andres	NNP
Motor	NNP
coalition	NN
idea	NN
bankrupt	JJ
organize	VB
beside	IN
distinction	NN
81	CD
1894	CD
Frozen	NNP
attempt	NN
Medford	NNP
reach	VB
printing	NN
:53	CD
deductibility	NN
Gaffney	NNP
surrounded	VBN
Round	NNP
Keizai	NNP
tapered	JJ
protests	NNS
filed	VBD
Cleburne	NNP
fervor	NN
Jamaica	NNP
searching	VBG
rest	NN
Spartanburg	NNP
Falls	NNP
surplus	NN
addressed	VBD
spinning	VBG
enhance	VB
Moscow	NNP
Pataki	NNP
Cray	NNP
gunners	NNS
deny	VBP
selling	VBG
Wilsonville	NNP
Throughout	IN
Miamisburg	NNP
research-and-development	NN
landscaper	NN
finances	VBZ
seal	NN
fully	RB
blue	JJ
Sets	NNPS
Gaillard	NNP
furious	JJ
downright	RB
refine	VB
output	NN
stalled	VBN
iron	NN
Inc.	NNP
underscore	VB
65	CD
chips	NNS
great	JJ
Pisit	NNP
Soviet-designed	JJ
priorities	NNS
Minneapolis-based	JJ
59,400	CD
hamstrung	VBN
Saturday	NNP
inventories	NNS
trading	NN
Emissions	NNS
precise	JJ
Majors	NNP
companies	NNS
speaker	NN
Silkowski	NNP
lending	VBG
Anderson	NNP
shutdowns	NNS
gathered	VBD
Treatment	NNP
Wallen	NNP
impression	NN
hormones	NNS
Florida	NNP
retained	VBD
northwest	JJS
Express	NNP
Fermilab	NNP
Exports	NNS
Greenville	NNP
blow	VB
Buffalo	NNP
Lehi	NNP
preferring	VBG
voting	NN
quits	VBZ
Islands	NNP
hollow	JJ
See	VB
merge	VB
Skokie	NN
silicones	NNS
best-selling	JJ
stopping	VBG
buy	VB
glut	NN
appealed	VBD
Zabriskie	NNP
CELIC	NNP
play	VB
Pagbilao	NNP
residents	NNS
corporation	NN
elections	NNS
equip	VB
stored	VBN
skin	NN
eliminate	VB
soil	NN
Because	IN
boot	NN
6.75	CD
year	NN
blues	NNS
hiding	VBG
Quonset	NNP
5.5	CD
how	WRB
hometown	NN
ultrafast	JJ
Stamford	NNP
Lady	JJ
rebuilt	JJ
ones	NNS
61	CD
health-insurance	NN
market	NN
revalued	VBD
recreated	JJ
enjoyed	VBN
supplies	NNS
tall	JJ
objections	NNS
Foster	NNP
una	NNP
stocks	NNS
interrogations	NNS
soup	NN
bought	VBD
spreading	VBG
Hispanic	JJ
series	NN
Between	IN
consultants	NNS
milling	JJ
equity	NN
mind	NN
Motors	NNPS
lesser-known	JJ
--are	VBP
obstacle	NN
Fremont	NNP
Israeli	JJ
slow	JJ
chip-making	NN
Film	NNP
spin	VB
win-win	NN
healthy	JJ
wherever	NNP
LYNN	NNP
Nearly	RB
HWY	NNP
Republican	NNP
1990s	CD
far	RB
208	CD
Any	DT
contenders	NNS
Cogeneration	NNP
Conrad	NNP
mosquito	JJ
bettering	VBG
Tianjin	NNP
Deutch	NNP
Auschwitz	NNP
:22	CD
858.2	CD
total	JJ
meantime	NN
enormous	JJ
laboratory	NN
feedstock	NN
soldiers	NNS
sought	VBN
decided	VBD
crowned	VBN
Losanno	NNP
production	NN
starts	VBZ
fits	VBZ
dozen	NN
Coco	NNP
receiving	VBG
distrust	VB
Opens	NNP
interstate	NN
pesos	NNS
Elbit	NN
partnership	NN
pathogens	NNS
appeals	NNS
long-broken	JJ
Fleer	NNP
pipes	NNS
181	CD
roomful	NN
Agreement	NNP
15,712	CD
Lanna	NNP
problem	NN
coming	VBG
fire	NN
Bangkok	NNP
truck-making	JJ
Peugeot	NNP
500,000	CD
agency	NN
heralded	VBD
aroma	NN
Yucatan	NNP
276	CD
